"","GEOID","STATE","PLACENS","BLKGRP","BLOCK","P0040001","P0040002","P0040003","P0040004","P0040005","P0040006","P0040007","P0040008","P0040009","P0040010","P0040011","P0020001","P0020002","P0020003","P0020004","P0020005","P0020006","P0020007","P0020008","P0020009","P0020010","P0020011","INTPTLON","INTPTLAT"
"1","482011000011","48",NA,"1",NA,3044,524,2520,2386,1597,459,8,313,0,9,134,3153,549,2604,2460,1633,481,11,324,0,11,144,"-095.3666708","+29.7522286"
"2","482011000012","48",NA,"2",NA,3127,717,2410,2323,1551,574,8,180,1,9,87,3390,825,2565,2466,1583,676,8,188,1,10,99,"-095.3562888","+29.7590264"
"3","482012104001","48",NA,"1",NA,1605,1240,365,337,229,82,1,19,1,5,28,2045,1616,429,393,270,90,1,19,1,12,36,"-095.3666295","+29.7893615"
"4","482012104002","48",NA,"2",NA,1505,942,563,530,136,377,2,11,0,4,33,2122,1159,963,908,149,733,2,11,0,13,55,"-095.3609490","+29.7863478"
"5","482012105001","48",NA,"1",NA,1682,1369,313,282,176,78,0,19,2,7,31,2221,1833,388,341,203,107,2,20,2,7,47,"-095.3621874","+29.7972828"
"6","482012105002","48",NA,"2",NA,1302,1022,280,271,99,158,0,8,3,3,9,1742,1411,331,317,114,185,3,9,3,3,14,"-095.3533496","+29.7953060"
"7","482012105003","48",NA,"3",NA,1055,794,261,248,132,107,0,8,0,1,13,1407,1040,367,347,146,191,0,9,0,1,20,"-095.3643688","+29.7938649"
"8","482012106001","48",NA,"1",NA,1019,665,354,347,300,20,2,20,0,5,7,1250,821,429,414,355,26,4,23,0,6,15,"-095.3614505","+29.8104679"
"9","482012106002","48",NA,"2",NA,1316,1026,290,274,226,21,2,24,0,1,16,1592,1271,321,303,247,26,2,27,0,1,18,"-095.3614806","+29.8035199"
"10","482012106003","48",NA,"3",NA,1864,1268,596,556,462,54,0,32,0,8,40,2323,1646,677,623,522,58,2,33,0,8,54,"-095.3694152","+29.8073372"
"11","482012107001","48",NA,"1",NA,1752,1291,461,448,145,287,0,13,0,3,13,2293,1752,541,513,166,327,1,16,0,3,28,"-095.3535208","+29.8067305"
"12","482012108001","48",NA,"1",NA,1078,566,512,501,52,445,0,3,0,1,11,1400,792,608,590,60,525,0,4,0,1,18,"-095.3449623","+29.7969902"
"13","482012108002","48",NA,"2",NA,921,599,322,304,43,256,5,0,0,0,18,1223,830,393,371,60,302,5,0,0,4,22,"-095.3457402","+29.7810234"
"14","482012109001","48",NA,"1",NA,1217,336,881,860,27,805,3,17,0,8,21,1616,539,1077,1041,33,976,3,21,0,8,36,"-095.3312426","+29.8041585"
"15","482012110001","48",NA,"1",NA,1514,590,924,899,33,856,0,9,0,1,25,1973,881,1092,1055,41,997,1,11,0,5,37,"-095.3321489","+29.7970912"
"16","482012111011","48",NA,"1",NA,824,334,490,484,29,448,3,0,2,2,6,1151,549,602,590,34,549,3,0,2,2,12,"-095.3381244","+29.7853714"
"17","482012111012","48",NA,"2",NA,1442,856,586,564,37,521,2,2,0,2,22,1896,1161,735,709,49,648,5,4,0,3,26,"-095.3337441","+29.7887535"
"18","482012111021","48",NA,"1",NA,551,233,318,313,12,300,0,0,0,1,5,759,370,389,380,16,363,0,0,0,1,9,"-095.3313365","+29.7826453"
"19","482012111022","48",NA,"2",NA,535,446,89,87,8,79,0,0,0,0,2,750,620,130,123,17,106,0,0,0,0,7,"-095.3293129","+29.7886679"
"20","482012111023","48",NA,"3",NA,695,323,372,356,11,342,0,1,0,2,16,968,502,466,442,21,417,1,1,0,2,24,"-095.3249183","+29.7885224"
"21","482012112001","48",NA,"1",NA,1137,344,793,758,19,737,1,0,0,1,35,1468,499,969,927,24,898,1,1,2,1,42,"-095.3205741","+29.8030878"
"22","482012112002","48",NA,"2",NA,1161,611,550,524,28,495,1,0,0,0,26,1520,866,654,624,30,592,1,0,0,1,30,"-095.3201300","+29.7922089"
"23","482012113011","48",NA,"1",NA,954,252,702,679,36,637,4,2,0,0,23,1514,414,1100,1060,42,1009,6,3,0,0,40,"-095.3373197","+29.7725983"
"24","482012113012","48",NA,"2",NA,900,311,589,558,42,503,5,3,0,5,31,1166,441,725,681,46,621,5,4,0,5,44,"-095.3312849","+29.7786447"
"25","482012113021","48",NA,"1",NA,597,154,443,432,10,418,2,1,0,1,11,752,240,512,501,12,483,2,3,0,1,11,"-095.3308498","+29.7734409"
"26","482012113022","48",NA,"2",NA,732,261,471,452,28,421,2,1,0,0,19,977,385,592,570,32,530,6,1,0,1,22,"-095.3203637","+29.7766615"
"27","482012113023","48",NA,"3",NA,661,201,460,432,49,376,0,3,1,3,28,865,299,566,534,61,463,2,4,1,3,32,"-095.3207075","+29.7820276"
"28","482012114001","48",NA,"1",NA,796,250,546,515,38,469,0,4,0,4,31,1059,376,683,647,46,591,0,4,0,6,36,"-095.3205624","+29.7721427"
"29","482012114002","48",NA,"2",NA,819,233,586,574,41,528,0,0,1,4,12,1343,334,1009,993,42,945,0,0,1,5,16,"-095.3225771","+29.7640076"
"30","482012114003","48",NA,"3",NA,1536,475,1061,1018,468,419,0,126,1,4,43,1855,595,1260,1210,502,574,3,126,1,4,50,"-095.3351495","+29.7656719"
"31","482012115011","48",NA,"1",NA,693,661,32,31,23,8,0,0,0,0,1,921,883,38,33,23,8,0,0,0,2,5,"-095.2895064","+29.7621394"
"32","482012115012","48",NA,"2",NA,1105,1064,41,37,31,3,1,0,0,2,4,1524,1477,47,40,32,3,1,0,0,4,7,"-095.3005177","+29.7663207"
"33","482012115013","48",NA,"3",NA,522,501,21,20,17,2,0,0,1,0,1,719,694,25,23,17,2,0,2,1,1,2,"-095.2949992","+29.7681686"
"34","482012115021","48",NA,"1",NA,1466,1233,233,228,30,186,10,1,0,1,5,1938,1636,302,296,39,244,10,2,0,1,6,"-095.3094456","+29.7681845"
"35","482012115022","48",NA,"2",NA,647,595,52,43,26,10,1,0,0,6,9,861,803,58,49,31,11,1,0,0,6,9,"-095.2920349","+29.7748856"
"36","482012116001","48",NA,"1",NA,980,715,265,254,71,183,0,0,0,0,11,1240,948,292,277,75,202,0,0,0,0,15,"-095.3115693","+29.7846713"
"37","482012116002","48",NA,"2",NA,1230,948,282,270,47,211,0,12,0,0,12,1605,1265,340,321,49,253,0,19,0,0,19,"-095.3116091","+29.7782170"
"38","482012117001","48",NA,"1",NA,1033,270,763,741,12,727,0,0,0,2,22,1403,437,966,934,18,912,0,2,0,2,32,"-095.3096190","+29.8047211"
"39","482012117002","48",NA,"2",NA,713,392,321,314,16,289,3,0,0,6,7,979,595,384,371,17,345,3,0,0,6,13,"-095.2990429","+29.7974186"
"40","482012117003","48",NA,"3",NA,1013,374,639,616,20,589,3,0,0,4,23,1350,554,796,764,22,731,3,0,0,8,32,"-095.3135860","+29.7947239"
"41","482012119001","48",NA,"1",NA,1050,1013,37,34,28,4,1,1,0,0,3,1444,1393,51,45,37,5,1,1,0,1,6,"-095.3050235","+29.7835609"
"42","482012119002","48",NA,"2",NA,896,864,32,31,21,7,0,3,0,0,1,1227,1179,48,43,25,9,3,5,0,1,5,"-095.2998398","+29.7855187"
"43","482012119003","48",NA,"3",NA,813,785,28,26,23,2,1,0,0,0,2,1084,1042,42,38,28,8,1,1,0,0,4,"-095.2940986","+29.7838646"
"44","482012119004","48",NA,"4",NA,719,683,36,32,22,8,0,2,0,0,4,962,911,51,43,28,9,1,2,0,3,8,"-095.2994968","+29.7819157"
"45","482012123001","48",NA,"1",NA,741,545,196,188,112,60,0,13,0,3,8,893,678,215,200,119,63,1,13,0,4,15,"-095.3577165","+29.7754741"
"46","482012123002","48",NA,"2",NA,605,514,91,90,56,27,0,7,0,0,1,778,668,110,106,64,31,2,9,0,0,4,"-095.3572332","+29.7805595"
"47","482012123003","48",NA,"3",NA,821,374,447,433,114,281,0,33,0,5,14,987,479,508,493,118,336,0,34,0,5,15,"-095.3557002","+29.7723273"
"48","482012123004","48",NA,"4",NA,897,792,105,84,54,27,1,0,0,2,21,1144,1025,119,97,60,29,1,2,0,5,22,"-095.3530053","+29.7789269"
"49","482012123005","48",NA,"5",NA,941,722,219,212,145,54,1,8,0,4,7,1225,974,251,242,157,70,2,9,0,4,9,"-095.3642197","+29.7782397"
"50","482012124001","48",NA,"1",NA,1034,974,60,55,33,21,1,0,0,0,5,1366,1290,76,66,38,27,1,0,0,0,10,"-095.2982935","+29.7778143"
"51","482012124002","48",NA,"2",NA,666,532,134,133,23,99,11,0,0,0,1,878,724,154,151,30,107,14,0,0,0,3,"-095.2814786","+29.7884972"
"52","482012124003","48",NA,"3",NA,523,494,29,27,11,10,6,0,0,0,2,703,670,33,29,11,10,8,0,0,0,4,"-095.3052173","+29.7771636"
"53","482012125001","48",NA,"1",NA,866,556,310,300,37,262,1,0,0,0,10,1177,787,390,378,38,336,1,3,0,0,12,"-095.2778707","+29.7695172"
"54","482012125002","48",NA,"2",NA,1275,401,874,864,10,853,0,0,0,1,10,1619,601,1018,1008,13,992,0,2,0,1,10,"-095.2701866","+29.7648373"
"55","482012125003","48",NA,"3",NA,811,183,628,609,13,593,2,0,0,1,19,996,277,719,700,17,677,3,2,0,1,19,"-095.2826081","+29.7479531"
"56","482012201001","48",NA,"1",NA,1494,747,747,730,33,690,0,2,0,5,17,2052,1120,932,909,41,855,2,5,0,6,23,"-095.3434635","+29.8151628"
"57","482012202001","48",NA,"1",NA,1320,1161,159,154,120,31,1,2,0,0,5,1659,1488,171,159,125,31,1,2,0,0,12,"-095.3690154","+29.8166572"
"58","482012202002","48",NA,"2",NA,756,654,102,94,61,20,6,7,0,0,8,966,856,110,98,62,20,6,9,0,1,12,"-095.3570002","+29.8163594"
"59","482012203001","48",NA,"1",NA,730,635,95,92,58,21,2,1,0,10,3,954,848,106,103,60,22,2,1,0,18,3,"-095.3720112","+29.8261424"
"60","482012203002","48",NA,"2",NA,706,653,53,53,34,8,0,8,0,3,0,943,875,68,66,36,14,3,8,0,5,2,"-095.3707179","+29.8217578"
"61","482012203003","48",NA,"3",NA,1576,1398,178,172,147,11,2,6,0,6,6,2075,1866,209,194,160,17,2,6,0,9,15,"-095.3612161","+29.8245533"
"62","482012204001","48",NA,"1",NA,921,794,127,124,33,88,0,2,1,0,3,1353,1171,182,177,49,122,1,2,1,2,5,"-095.3732481","+29.8351871"
"63","482012204002","48",NA,"2",NA,1711,1566,145,128,92,28,2,6,0,0,17,2339,2169,170,151,111,30,2,6,0,2,19,"-095.3618924","+29.8331429"
"64","482012204003","48",NA,"3",NA,714,657,57,50,35,13,0,1,1,0,7,975,904,71,63,43,17,0,2,1,0,8,"-095.3719698","+29.8308239"
"65","482012205001","48",NA,"1",NA,627,472,155,147,78,59,4,4,0,2,8,889,701,188,172,86,76,4,4,0,2,16,"-095.3788957","+29.8284908"
"66","482012205002","48",NA,"2",NA,1621,1177,444,433,245,172,6,6,0,4,11,2073,1563,510,490,261,201,8,8,0,12,20,"-095.3801321","+29.8414837"
"67","482012205003","48",NA,"3",NA,707,314,393,379,72,295,2,8,0,2,14,791,384,407,389,74,303,2,8,0,2,18,"-095.3872716","+29.8412689"
"68","482012205004","48",NA,"4",NA,531,337,194,180,29,140,0,11,0,0,14,717,507,210,194,35,143,0,13,0,3,16,"-095.3804872","+29.8363102"
"69","482012206001","48",NA,"1",NA,754,674,80,72,49,14,0,5,0,4,8,1037,938,99,86,51,20,0,11,0,4,13,"-095.3722218","+29.8418502"
"70","482012206002","48",NA,"2",NA,1004,593,411,409,59,345,4,1,0,0,2,1666,854,812,808,75,725,4,4,0,0,4,"-095.3660921","+29.8428683"
"71","482012206003","48",NA,"3",NA,737,675,62,60,43,10,5,0,0,2,2,1030,958,72,66,49,10,5,0,0,2,6,"-095.3613872","+29.8411897"
"72","482012207011","48",NA,"1",NA,836,460,376,373,53,320,0,0,0,0,3,1133,655,478,474,62,412,0,0,0,0,4,"-095.3456789","+29.8431806"
"73","482012207012","48",NA,"2",NA,688,605,83,74,25,44,0,4,0,1,9,983,880,103,90,27,56,0,4,0,3,13,"-095.3516506","+29.8369387"
"74","482012207013","48",NA,"3",NA,676,406,270,265,41,224,0,0,0,0,5,1125,619,506,501,50,451,0,0,0,0,5,"-095.3538427","+29.8433483"
"75","482012207021","48",NA,"1",NA,721,593,128,124,11,110,0,3,0,0,4,1002,859,143,139,16,117,3,3,0,0,4,"-095.3458268","+29.8335636"
"76","482012207022","48",NA,"2",NA,578,435,143,138,16,121,1,0,0,0,5,776,614,162,156,16,139,1,0,0,0,6,"-095.3463471","+29.8255224"
"77","482012207023","48",NA,"3",NA,963,743,220,209,24,176,0,7,0,2,11,1387,1127,260,248,30,208,1,7,0,2,12,"-095.3510369","+29.8253110"
"78","482012208001","48",NA,"1",NA,740,544,196,191,14,163,0,10,0,4,5,1095,843,252,242,21,204,0,13,0,4,10,"-095.3384078","+29.8365815"
"79","482012208002","48",NA,"2",NA,704,264,440,435,44,389,0,2,0,0,5,1168,420,748,734,55,676,0,3,0,0,14,"-095.3405399","+29.8262188"
"80","482012208003","48",NA,"3",NA,670,319,351,347,6,336,2,3,0,0,4,935,496,439,433,6,422,2,3,0,0,6,"-095.3368235","+29.8231045"
"81","482012209001","48",NA,"1",NA,1427,1062,365,342,97,222,0,17,2,4,23,1907,1448,459,429,110,291,0,20,2,6,30,"-095.3376376","+29.8488405"
"82","482012210001","48",NA,"1",NA,1368,980,388,366,75,267,2,0,0,22,22,2017,1430,587,554,96,419,2,2,0,35,33,"-095.3455448","+29.8651227"
"83","482012210002","48",NA,"2",NA,1650,1440,210,202,82,113,2,0,0,5,8,2271,2011,260,250,92,151,2,0,0,5,10,"-095.3448183","+29.8549165"
"84","482012211001","48",NA,"1",NA,1154,1067,87,84,76,6,0,2,0,0,3,1611,1516,95,89,80,6,0,2,0,1,6,"-095.3599024","+29.8660546"
"85","482012211002","48",NA,"2",NA,792,687,105,102,70,31,0,1,0,0,3,1130,995,135,128,91,32,0,1,0,4,7,"-095.3557624","+29.8564371"
"86","482012211003","48",NA,"3",NA,739,671,68,66,54,9,0,2,0,1,2,977,896,81,76,61,12,0,2,0,1,5,"-095.3549398","+29.8504294"
"87","482012212001","48",NA,"1",NA,1449,1258,191,186,143,32,0,4,1,6,5,2005,1775,230,222,151,52,6,4,1,8,8,"-095.3678128","+29.8660320"
"88","482012212002","48",NA,"2",NA,763,678,85,80,55,23,1,1,0,0,5,1092,984,108,102,69,28,1,1,0,3,6,"-095.3676001","+29.8606950"
"89","482012212003","48",NA,"3",NA,900,819,81,77,64,11,0,2,0,0,4,1331,1242,89,82,66,14,0,2,0,0,7,"-095.3783523","+29.8619330"
"90","482012212004","48",NA,"4",NA,1259,1083,176,171,143,18,0,0,0,10,5,1696,1494,202,190,152,25,3,0,0,10,12,"-095.3784165","+29.8673461"
"91","482012213011","48",NA,"1",NA,1587,1432,155,146,118,19,0,5,0,4,9,2234,2028,206,195,144,27,4,5,0,15,11,"-095.3783409","+29.8495871"
"92","482012213012","48",NA,"2",NA,1661,1493,168,163,135,19,0,3,1,5,5,2252,2060,192,182,145,21,1,3,1,11,10,"-095.3781385","+29.8564283"
"93","482012213021","48",NA,"1",NA,1236,1133,103,100,56,27,1,11,0,5,3,1723,1595,128,122,62,43,1,11,0,5,6,"-095.3658542","+29.8489522"
"94","482012213022","48",NA,"2",NA,634,562,72,64,47,12,3,0,0,2,8,890,807,83,74,52,16,3,0,0,3,9,"-095.3666011","+29.8573064"
"95","482012213023","48",NA,"3",NA,805,734,71,64,44,17,0,1,0,2,7,1071,992,79,72,51,18,0,1,0,2,7,"-095.3665720","+29.8540194"
"96","482012214001","48",NA,"1",NA,744,666,78,76,22,54,0,0,0,0,2,1055,951,104,100,26,70,0,0,0,4,4,"-095.3935288","+29.8501334"
"97","482012214002","48",NA,"2",NA,1643,1425,218,207,173,22,0,3,1,8,11,2247,1985,262,250,200,33,0,7,1,9,12,"-095.3877765","+29.8525877"
"98","482012214003","48",NA,"3",NA,1879,1420,459,443,180,239,5,11,0,8,16,2600,2039,561,539,219,290,7,11,0,12,22,"-095.3959444","+29.8566944"
"99","482012215011","48",NA,"1",NA,1904,1733,171,168,102,26,1,36,0,3,3,2787,2558,229,223,125,45,5,45,0,3,6,"-095.3880389","+29.8672316"
"100","482012215012","48",NA,"2",NA,1575,1285,290,288,149,122,4,9,0,4,2,2154,1825,329,319,174,127,4,10,0,4,10,"-095.3987457","+29.8632113"
"101","482012215021","48",NA,"1",NA,826,437,389,372,14,338,1,19,0,0,17,1204,662,542,513,24,457,3,28,0,1,29,"-095.4046267","+29.8673786"
"102","482012215022","48",NA,"2",NA,1040,777,263,254,14,236,2,1,0,1,9,1655,1241,414,393,22,367,2,1,0,1,21,"-095.4001847","+29.8670875"
"103","482012216011","48",NA,"1",NA,1104,935,169,163,130,16,4,8,0,5,6,1539,1349,190,179,141,19,5,8,0,6,11,"-095.4087305","+29.8929975"
"104","482012216012","48",NA,"2",NA,1201,1103,98,91,80,8,0,3,0,0,7,1774,1654,120,107,96,8,0,3,0,0,13,"-095.4011077","+29.8930048"
"105","482012216021","48",NA,"1",NA,1058,837,221,213,171,22,0,18,0,2,8,1397,1136,261,249,193,32,0,18,0,6,12,"-095.3935981","+29.8799842"
"106","482012216022","48",NA,"2",NA,1236,1036,200,192,152,21,1,18,0,0,8,1745,1530,215,205,157,25,1,22,0,0,10,"-095.3971467","+29.8731949"
"107","482012216023","48",NA,"3",NA,1950,1638,312,302,234,51,2,12,0,3,10,2744,2400,344,331,252,61,3,12,0,3,13,"-095.4038822","+29.8818744"
"108","482012217011","48",NA,"1",NA,1593,1444,149,146,121,20,5,0,0,0,3,2288,2113,175,170,139,24,5,0,0,2,5,"-095.3785577","+29.8802173"
"109","482012217012","48",NA,"2",NA,378,343,35,35,17,14,0,4,0,0,0,528,492,36,36,17,15,0,4,0,0,0,"-095.3784489","+29.8714843"
"110","482012217013","48",NA,"3",NA,912,824,88,80,69,8,2,0,0,1,8,1270,1169,101,93,76,10,2,1,0,4,8,"-095.3755369","+29.8742699"
"111","482012217021","48",NA,"1",NA,1182,989,193,182,89,18,0,75,0,0,11,1734,1487,247,229,114,18,0,93,1,3,18,"-095.3763606","+29.8879534"
"112","482012217022","48",NA,"2",NA,1156,1091,65,63,51,7,0,5,0,0,2,1840,1763,77,74,56,7,0,5,0,6,3,"-095.3898053","+29.8879860"
"113","482012218001","48",NA,"1",NA,1096,973,123,115,87,21,0,2,2,3,8,1542,1400,142,130,97,26,0,2,2,3,12,"-095.3601405","+29.8751668"
"114","482012218002","48",NA,"2",NA,1117,1058,59,57,36,13,3,5,0,0,2,1786,1709,77,75,53,14,3,5,0,0,2,"-095.3650690","+29.8892027"
"115","482012218003","48",NA,"3",NA,718,653,65,64,55,3,2,0,0,4,1,1043,964,79,77,68,3,2,0,0,4,2,"-095.3622014","+29.8825140"
"116","482012219001","48",NA,"1",NA,1018,904,114,111,79,22,0,6,0,4,3,1473,1324,149,144,101,26,1,8,0,8,5,"-095.3495012","+29.8874652"
"117","482012219002","48",NA,"2",NA,836,752,84,82,73,8,0,1,0,0,2,1215,1119,96,91,78,9,0,1,0,3,5,"-095.3502003","+29.8805386"
"118","482012219003","48",NA,"3",NA,1360,1259,101,98,72,22,0,0,0,4,3,1996,1864,132,124,86,31,0,0,0,7,8,"-095.3480875","+29.8748485"
"119","482012220001","48",NA,"1",NA,1678,1341,337,330,220,99,6,5,0,0,7,2290,1906,384,373,246,107,6,5,0,9,11,"-095.3369210","+29.8680795"
"120","482012221001","48",NA,"1",NA,1805,1640,165,161,103,46,1,0,0,11,4,2638,2428,210,197,127,57,1,0,0,12,13,"-095.3326578","+29.8769483"
"121","482012221002","48",NA,"2",NA,899,805,94,91,65,21,1,2,0,2,3,1251,1142,109,106,74,27,1,2,0,2,3,"-095.3347291","+29.8831545"
"122","482012221003","48",NA,"3",NA,1177,1041,136,136,94,31,0,5,0,6,0,1598,1444,154,151,104,35,0,5,0,7,3,"-095.3410431","+29.8828622"
"123","482012222001","48",NA,"1",NA,1198,1004,194,186,121,62,1,2,0,0,8,1707,1500,207,198,128,64,1,2,0,3,9,"-095.3226835","+29.8974370"
"124","482012222002","48",NA,"2",NA,1501,1173,328,316,88,203,1,15,0,9,12,2105,1690,415,396,108,255,1,21,0,11,19,"-095.3255305","+29.8868041"
"125","482012223001","48",NA,"1",NA,1645,1384,261,248,183,50,0,10,0,5,13,2425,2093,332,298,222,58,0,13,0,5,34,"-095.3414059","+29.8929919"
"126","482012223002","48",NA,"2",NA,849,715,134,133,94,21,2,15,0,1,1,1311,1136,175,174,119,27,2,17,0,9,1,"-095.3675050","+29.8990792"
"127","482012223003","48",NA,"3",NA,766,687,79,76,53,19,0,4,0,0,3,1110,1020,90,84,60,19,0,5,0,0,6,"-095.3339838","+29.8959310"
"128","482012224011","48",NA,"1",NA,1269,1101,168,164,121,14,1,27,1,0,4,1831,1622,209,202,152,17,1,29,1,2,7,"-095.3865446","+29.8982064"
"129","482012224012","48",NA,"2",NA,1308,1166,142,136,89,11,6,30,0,0,6,1946,1769,177,168,101,15,11,38,0,3,9,"-095.4047171","+29.9052388"
"130","482012224021","48",NA,"1",NA,2028,1671,357,340,188,121,2,21,0,8,17,2816,2372,444,421,226,159,3,22,0,11,23,"-095.3937708","+29.9111052"
"131","482012224022","48",NA,"2",NA,601,489,112,105,80,10,0,15,0,0,7,900,768,132,124,98,11,0,15,0,0,8,"-095.3977878","+29.9079710"
"132","482012224023","48",NA,"3",NA,1401,1222,179,167,114,45,0,5,0,3,12,2042,1817,225,210,135,67,0,5,0,3,15,"-095.3774949","+29.9076414"
"133","482012225011","48",NA,"1",NA,1180,1117,63,63,17,37,0,9,0,0,0,1885,1793,92,89,32,47,0,9,0,1,3,"-095.4061291","+29.9265415"
"134","482012225012","48",NA,"2",NA,1201,1037,164,161,77,37,5,33,5,4,3,1735,1525,210,201,97,46,9,37,5,7,9,"-095.4057653","+29.9287699"
"135","482012225021","48",NA,"1",NA,1107,967,140,132,102,12,0,17,0,1,8,1654,1475,179,169,126,25,0,17,0,1,10,"-095.3846237","+29.9249997"
"136","482012225022","48",NA,"2",NA,1965,1657,308,307,205,80,2,13,0,7,1,2741,2377,364,358,233,95,2,19,0,9,6,"-095.3955645","+29.9243713"
"137","482012225041","48",NA,"1",NA,957,799,158,140,30,97,0,10,0,3,18,1508,1286,222,202,47,132,1,11,0,11,20,"-095.4036261","+29.9232091"
"138","482012225042","48",NA,"2",NA,1188,1073,115,107,31,62,0,10,0,4,8,1837,1698,139,128,35,71,2,12,1,7,11,"-095.4066684","+29.9228732"
"139","482012225051","48",NA,"1",NA,984,867,117,115,68,35,0,10,0,2,2,1379,1243,136,130,73,45,0,10,0,2,6,"-095.4047553","+29.9166073"
"140","482012225052","48",NA,"2",NA,1150,1033,117,114,67,42,0,4,0,1,3,1607,1472,135,123,71,47,0,4,0,1,12,"-095.3972351","+29.9220727"
"141","482012226011","48",NA,"1",NA,916,845,71,70,24,12,1,33,0,0,1,1416,1313,103,102,29,25,1,47,0,0,1,"-095.3985466","+29.9332587"
"142","482012226012","48",NA,"2",NA,679,378,301,288,59,193,1,18,3,14,13,906,549,357,341,64,236,1,19,3,18,16,"-095.3888898","+29.9354035"
"143","482012226021","48",NA,"1",NA,455,221,234,232,18,203,0,3,8,0,2,616,308,308,306,20,271,0,3,12,0,2,"-095.4002835","+29.9383058"
"144","482012226022","48",NA,"2",NA,767,385,382,371,30,324,2,15,0,0,11,1008,574,434,423,35,363,2,21,0,2,11,"-095.4063013","+29.9344537"
"145","482012226023","48",NA,"3",NA,776,319,457,431,58,363,0,3,1,6,26,1070,471,599,567,67,483,0,5,1,11,32,"-095.4081372","+29.9387036"
"146","482012227011","48",NA,"1",NA,1014,47,967,961,12,949,0,0,0,0,6,1631,94,1537,1518,12,1506,0,0,0,0,19,"-095.3012583","+29.9352513"
"147","482012227012","48",NA,"2",NA,495,313,182,174,67,106,0,1,0,0,8,729,456,273,250,73,173,0,1,0,3,23,"-095.3065226","+29.9331629"
"148","482012227021","48",NA,"1",NA,1408,125,1283,1258,57,1184,0,11,1,5,25,2119,185,1934,1893,65,1810,0,11,1,6,41,"-095.3115521","+29.9340694"
"149","482012227022","48",NA,"2",NA,922,371,551,536,66,456,0,8,0,6,15,1413,527,886,864,69,768,1,11,0,15,22,"-095.3448022","+29.9335615"
"150","482012228001","48",NA,"1",NA,606,427,179,170,146,18,1,5,0,0,9,822,629,193,182,152,18,7,5,0,0,11,"-095.3657928","+29.9234175"
"151","482012228002","48",NA,"2",NA,798,693,105,104,87,7,2,8,0,0,1,1230,1111,119,118,100,7,2,9,0,0,1,"-095.3691288","+29.9098795"
"152","482012228003","48",NA,"3",NA,907,791,116,105,41,2,2,59,1,0,11,1268,1137,131,117,49,2,2,60,1,3,14,"-095.3593705","+29.9094737"
"153","482012229001","48",NA,"1",NA,1089,824,265,251,122,104,2,18,3,2,14,1582,1257,325,302,146,126,3,20,3,4,23,"-095.3491708","+29.9217730"
"154","482012229002","48",NA,"2",NA,906,761,145,141,100,33,0,4,3,1,4,1318,1149,169,163,107,48,0,4,3,1,6,"-095.3466645","+29.9091589"
"155","482012229003","48",NA,"3",NA,1436,1224,212,205,102,77,0,19,0,7,7,2024,1764,260,250,124,94,0,19,0,13,10,"-095.3440404","+29.9042066"
"156","482012229004","48",NA,"4",NA,1336,1119,217,211,78,102,7,21,2,1,6,1768,1512,256,250,82,130,12,21,3,2,6,"-095.3364793","+29.9090674"
"157","482012229005","48",NA,"5",NA,959,706,253,245,12,207,1,15,4,6,8,1338,1023,315,307,15,264,1,17,4,6,8,"-095.3348645","+29.9173735"
"158","482012230011","48",NA,"1",NA,1308,1063,245,241,120,119,0,2,0,0,4,1750,1464,286,278,138,138,0,2,0,0,8,"-095.3251290","+29.9152058"
"159","482012230012","48",NA,"2",NA,1382,1169,213,197,75,111,0,7,0,4,16,2135,1857,278,256,93,152,0,7,0,4,22,"-095.3146825","+29.9067209"
"160","482012230021","48",NA,"1",NA,1193,932,261,250,85,144,1,19,1,0,11,1628,1323,305,294,103,164,3,21,1,2,11,"-095.3276250","+29.9084121"
"161","482012230022","48",NA,"2",NA,530,494,36,36,20,9,0,7,0,0,0,838,779,59,59,29,20,0,7,0,3,0,"-095.3293477","+29.9031426"
"162","482012230023","48",NA,"3",NA,975,800,175,171,33,129,0,9,0,0,4,1538,1316,222,214,37,168,0,9,0,0,8,"-095.3272588","+29.9045026"
"163","482012231001","48",NA,"1",NA,1580,1260,320,309,186,99,1,14,0,9,11,2233,1864,369,350,208,113,1,16,0,12,19,"-095.3245004","+29.9236934"
"164","482012301001","48",NA,"1",NA,1191,319,872,860,11,842,1,2,0,4,12,1824,542,1282,1257,13,1235,1,2,0,6,25,"-095.3302290","+29.8138484"
"165","482012302001","48",NA,"1",NA,661,141,520,510,53,448,2,3,0,4,10,803,209,594,581,60,512,2,3,0,4,13,"-095.3153700","+29.8125053"
"166","482012302002","48",NA,"2",NA,528,167,361,347,14,328,0,3,0,2,14,719,270,449,430,20,404,0,3,0,3,19,"-095.3161463","+29.8223921"
"167","482012302003","48",NA,"3",NA,1082,184,898,879,11,867,0,1,0,0,19,1631,284,1347,1326,12,1312,0,1,0,1,21,"-095.3076335","+29.8198770"
"168","482012302004","48",NA,"4",NA,1073,306,767,751,28,713,1,4,0,5,16,1449,507,942,920,34,875,1,4,0,6,22,"-095.3001237","+29.8293344"
"169","482012302005","48",NA,"5",NA,586,147,439,427,5,422,0,0,0,0,12,778,235,543,521,5,515,0,0,0,1,22,"-095.2964843","+29.8139487"
"170","482012303001","48",NA,"1",NA,1089,375,714,693,35,656,0,1,0,1,21,1441,599,842,815,39,774,0,1,0,1,27,"-095.3112228","+29.8375701"
"171","482012303002","48",NA,"2",NA,612,250,362,357,7,349,1,0,0,0,5,857,388,469,461,11,449,1,0,0,0,8,"-095.3149939","+29.8304232"
"172","482012304001","48",NA,"1",NA,629,253,376,368,15,344,0,4,0,5,8,835,348,487,474,22,443,0,4,0,5,13,"-095.3212850","+29.8333101"
"173","482012304002","48",NA,"2",NA,1143,519,624,613,22,588,1,0,0,2,11,1608,826,782,763,29,731,1,0,0,2,19,"-095.3254314","+29.8334794"
"174","482012304003","48",NA,"3",NA,986,631,355,348,29,319,0,0,0,0,7,1381,941,440,431,48,383,0,0,0,0,9,"-095.3290872","+29.8239066"
"175","482012305001","48",NA,"1",NA,841,735,106,103,46,53,0,2,1,1,3,1165,1048,117,108,47,54,0,2,1,4,9,"-095.3251567","+29.8592466"
"176","482012305002","48",NA,"2",NA,930,808,122,116,34,71,3,7,0,1,6,1331,1171,160,150,52,82,3,7,0,6,10,"-095.3290466","+29.8525911"
"177","482012305003","48",NA,"3",NA,1182,822,360,340,19,306,0,9,0,6,20,1603,1180,423,395,20,355,0,9,0,11,28,"-095.3309375","+29.8394005"
"178","482012306001","48",NA,"1",NA,919,429,490,481,6,469,2,3,0,1,9,1239,652,587,574,6,561,2,3,0,2,13,"-095.3028386","+29.8449265"
"179","482012306002","48",NA,"2",NA,1105,437,668,648,18,608,0,14,0,8,20,1451,686,765,736,18,692,2,14,0,10,29,"-095.3164626","+29.8448117"
"180","482012307001","48",NA,"1",NA,655,366,289,276,18,252,0,5,0,1,13,875,538,337,318,21,290,0,6,0,1,19,"-095.3158676","+29.8551176"
"181","482012307002","48",NA,"2",NA,1471,323,1148,1134,20,1108,0,5,0,1,14,2088,549,1539,1518,25,1484,2,6,0,1,21,"-095.3047129","+29.8511549"
"182","482012308001","48",NA,"1",NA,987,328,659,642,27,607,1,6,0,1,17,1294,507,787,767,32,726,1,6,0,2,20,"-095.2931787","+29.8431137"
"183","482012308002","48",NA,"2",NA,1050,297,753,734,26,707,0,1,0,0,19,1368,463,905,884,27,856,0,1,0,0,21,"-095.2944260","+29.8355912"
"184","482012309001","48",NA,"1",NA,1100,359,741,726,33,687,0,0,1,5,15,1452,576,876,858,36,815,0,0,1,6,18,"-095.2767570","+29.8265348"
"185","482012309002","48",NA,"2",NA,756,300,456,452,17,432,0,3,0,0,4,1059,482,577,564,18,540,0,6,0,0,13,"-095.2808930","+29.8164462"
"186","482012309003","48",NA,"3",NA,819,379,440,431,12,417,1,0,1,0,9,1142,586,556,543,12,529,1,0,1,0,13,"-095.2758111","+29.8117943"
"187","482012309004","48",NA,"4",NA,792,187,605,600,16,578,0,2,2,2,5,1294,325,969,963,21,931,0,3,2,6,6,"-095.2881956","+29.8193300"
"188","482012310001","48",NA,"1",NA,2031,829,1202,1160,46,1095,8,4,0,7,42,2759,1207,1552,1500,51,1423,8,7,0,11,52,"-095.2739155","+29.8385245"
"189","482012310002","48",NA,"2",NA,1461,648,813,795,39,746,2,5,0,3,18,1968,971,997,977,40,925,2,5,0,5,20,"-095.2823925","+29.8392372"
"190","482012311001","48",NA,"1",NA,1361,722,639,623,70,546,3,1,0,3,16,2052,1119,933,906,77,822,3,1,0,3,27,"-095.2500065","+29.8277499"
"191","482012311002","48",NA,"2",NA,972,667,305,295,40,255,0,0,0,0,10,1346,963,383,372,48,324,0,0,0,0,11,"-095.2556200","+29.8416195"
"192","482012311003","48",NA,"3",NA,1046,755,291,285,45,230,0,8,0,2,6,1522,1165,357,348,48,290,0,8,0,2,9,"-095.2604041","+29.8385124"
"193","482012312001","48",NA,"1",NA,1378,411,967,949,27,917,0,3,1,1,18,1834,639,1195,1169,31,1132,0,3,1,2,26,"-095.2397137","+29.8456176"
"194","482012312002","48",NA,"2",NA,1197,314,883,868,13,854,0,0,0,1,15,1801,489,1312,1292,18,1272,0,0,0,2,20,"-095.2580631","+29.8540626"
"195","482012312003","48",NA,"3",NA,711,445,266,251,18,227,0,1,1,4,15,1096,710,386,359,24,320,0,4,2,9,27,"-095.2551592","+29.8659714"
"196","482012312004","48",NA,"4",NA,1354,415,939,930,16,911,0,0,0,3,9,2069,623,1446,1435,19,1412,0,0,0,4,11,"-095.2473537","+29.8750830"
"197","482012313001","48",NA,"1",NA,1734,541,1193,1170,54,1107,2,3,0,4,23,2501,835,1666,1635,67,1558,3,3,0,4,31,"-095.2693428","+29.8638148"
"198","482012313002","48",NA,"2",NA,1758,433,1325,1295,41,1237,3,5,0,9,30,2295,677,1618,1563,48,1494,5,7,0,9,55,"-095.2695151","+29.8511661"
"199","482012314001","48",NA,"1",NA,2555,612,1943,1918,41,1849,9,11,0,8,25,3347,928,2419,2378,47,2294,11,11,0,15,41,"-095.2870796","+29.8637479"
"200","482012315001","48",NA,"1",NA,1255,297,958,941,15,923,0,2,0,1,17,1628,462,1166,1144,22,1119,0,2,0,1,22,"-095.2969664","+29.8627656"
"201","482012315002","48",NA,"2",NA,899,125,774,756,14,737,0,0,0,5,18,1235,207,1028,990,19,962,2,0,0,7,38,"-095.2959595","+29.8557456"
"202","482012316001","48",NA,"1",NA,944,301,643,629,26,598,0,5,0,0,14,1238,447,791,772,26,741,0,5,0,0,19,"-095.3104933","+29.8637542"
"203","482012316002","48",NA,"2",NA,1274,281,993,969,13,950,0,3,0,3,24,1677,490,1187,1156,16,1134,0,3,0,3,31,"-095.3056047","+29.8604886"
"204","482012317001","48",NA,"1",NA,2009,1815,194,178,87,77,10,3,0,1,16,3134,2898,236,213,93,99,15,3,0,3,23,"-095.3163286","+29.8818102"
"205","482012317002","48",NA,"2",NA,935,848,87,82,50,26,0,6,0,0,5,1375,1254,121,116,68,31,1,6,0,10,5,"-095.3245208","+29.8686106"
"206","482012318001","48",NA,"1",NA,830,317,513,506,1,491,0,7,0,7,7,1152,530,622,612,7,585,0,9,0,11,10,"-095.3078484","+29.8698750"
"207","482012318002","48",NA,"2",NA,1326,876,450,444,63,375,0,5,0,1,6,1914,1352,562,552,76,467,0,5,0,4,10,"-095.3062533","+29.8807023"
"208","482012319001","48",NA,"1",NA,1434,371,1063,1030,16,1000,2,0,0,12,33,1857,561,1296,1256,16,1221,3,2,0,14,40,"-095.2917889","+29.8856313"
"209","482012319002","48",NA,"2",NA,1855,747,1108,1098,90,983,0,20,0,5,10,2569,1248,1321,1303,95,1178,0,21,0,9,18,"-095.2745726","+29.8790854"
"210","482012319003","48",NA,"3",NA,906,218,688,680,6,671,3,0,0,0,8,1175,340,835,826,8,811,4,0,0,3,9,"-095.2931750","+29.8755471"
"211","482012319004","48",NA,"4",NA,737,278,459,444,15,424,0,1,0,4,15,1032,434,598,578,20,552,0,1,1,4,20,"-095.2985025","+29.8807504"
"212","482012320001","48",NA,"1",NA,1313,220,1093,1075,16,1051,0,8,0,0,18,1648,378,1270,1249,21,1217,0,11,0,0,21,"-095.2926517","+29.9068231"
"213","482012320002","48",NA,"2",NA,671,532,139,135,29,97,1,6,1,1,4,1112,910,202,192,36,145,1,6,1,3,10,"-095.2967434","+29.8962690"
"214","482012320003","48",NA,"3",NA,1089,874,215,203,62,119,1,15,0,6,12,1611,1350,261,244,69,143,1,22,0,9,17,"-095.2620700","+29.9033513"
"215","482012321001","48",NA,"1",NA,1081,599,482,470,77,386,1,3,3,0,12,1643,933,710,689,96,581,2,5,3,2,21,"-095.3089723","+29.8967196"
"216","482012321002","48",NA,"2",NA,1504,991,513,489,149,328,0,8,1,3,24,2160,1483,677,647,167,456,1,10,1,12,30,"-095.3056487","+29.9112241"
"217","482012322011","48",NA,"1",NA,1617,764,853,838,360,428,2,47,0,1,15,2187,1117,1070,1048,407,581,2,56,1,1,22,"-095.2779297","+29.9373471"
"218","482012322012","48",NA,"2",NA,2354,1612,742,702,310,341,10,26,3,12,40,3567,2562,1005,948,365,518,11,30,7,17,57,"-095.2936849","+29.9270062"
"219","482012322021","48",NA,"1",NA,1120,619,501,467,273,123,4,67,0,0,34,1695,1006,689,636,361,183,4,88,0,0,53,"-095.2827083","+29.9224911"
"220","482012322022","48",NA,"2",NA,2625,438,2187,2097,1233,443,11,381,3,26,90,4003,729,3274,3083,1857,650,13,517,3,43,191,"-095.2692965","+29.9258700"
"221","482012322031","48",NA,"1",NA,1445,288,1157,1104,383,598,6,111,0,6,53,1927,384,1543,1451,484,803,7,145,4,8,92,"-095.2641051","+29.9338257"
"222","482012322032","48",NA,"2",NA,2847,640,2207,2142,728,1107,11,256,7,33,65,3997,992,3005,2875,945,1538,12,331,9,40,130,"-095.2325019","+29.9168535"
"223","482012323031","48",NA,"1",NA,2631,1419,1212,1185,125,1028,3,11,13,5,27,4208,2345,1863,1807,168,1593,3,13,17,13,56,"-095.2217781","+29.8906927"
"224","482012323032","48",NA,"2",NA,1467,792,675,658,68,570,1,10,5,4,17,2243,1296,947,916,106,779,2,14,6,9,31,"-095.2151989","+29.9044075"
"225","482012323041","48",NA,"1",NA,1386,1031,355,351,107,242,2,0,0,0,4,2251,1618,633,629,138,487,4,0,0,0,4,"-095.2193007","+29.8525972"
"226","482012323042","48",NA,"2",NA,1235,885,350,308,234,62,3,7,0,2,42,1747,1338,409,362,264,73,5,7,0,13,47,"-095.2231575","+29.8373468"
"227","482012323043","48",NA,"3",NA,2324,981,1343,1324,192,1111,1,11,0,9,19,3776,1702,2074,2038,242,1763,8,16,0,9,36,"-095.2166374","+29.8726614"
"228","482012323051","48",NA,"1",NA,4164,2390,1774,1730,252,1386,5,59,6,22,44,6511,3841,2670,2588,344,2133,5,70,6,30,82,"-095.2033898","+29.8754695"
"229","482012323052","48",NA,"2",NA,1201,548,653,627,79,528,0,10,1,9,26,1668,821,847,816,93,697,0,12,1,13,31,"-095.2071262","+29.8546560"
"230","482012323053","48",NA,"3",NA,1736,1089,647,627,94,511,0,19,0,3,20,2778,1831,947,912,130,756,0,22,0,4,35,"-095.2056838","+29.8621585"
"231","482012323061","48",NA,"1",NA,737,350,387,379,31,345,0,2,0,1,8,980,504,476,468,37,426,0,3,0,2,8,"-095.2056693","+29.8486414"
"232","482012323062","48",NA,"2",NA,573,394,179,162,118,30,4,0,1,9,17,777,555,222,202,145,41,4,0,1,11,20,"-095.2083296","+29.8406860"
"233","482012323063","48",NA,"3",NA,1282,670,612,601,77,488,4,22,1,9,11,1887,1042,845,831,106,688,4,22,1,10,14,"-095.1924490","+29.8485194"
"234","482012324021","48",NA,"1",NA,1368,603,765,744,39,683,0,21,0,1,21,1940,903,1037,1012,52,925,0,32,0,3,25,"-095.1866544","+29.8098248"
"235","482012324022","48",NA,"2",NA,1363,879,484,459,95,312,5,43,0,4,25,1880,1222,658,617,114,439,5,44,0,15,41,"-095.1894719","+29.8141107"
"236","482012324031","48",NA,"1",NA,1579,1037,542,520,114,365,3,28,3,7,22,2316,1579,737,705,138,526,3,28,3,7,32,"-095.2039446","+29.8118399"
"237","482012324032","48",NA,"2",NA,1710,1030,680,663,78,529,0,46,0,10,17,2259,1411,848,815,90,667,0,46,1,11,33,"-095.1969222","+29.8102775"
"238","482012324041","48",NA,"1",NA,956,645,311,300,256,16,1,15,0,12,11,1363,985,378,363,300,29,1,16,0,17,15,"-095.1926082","+29.8365515"
"239","482012324042","48",NA,"2",NA,731,482,249,234,202,15,1,10,0,6,15,1032,738,294,277,226,26,2,15,0,8,17,"-095.2039214","+29.8314131"
"240","482012324043","48",NA,"3",NA,853,551,302,295,168,111,0,14,0,2,7,1257,871,386,376,226,129,2,17,0,2,10,"-095.1871024","+29.8322174"
"241","482012324051","48",NA,"1",NA,1232,949,283,272,65,180,0,24,0,3,11,1751,1357,394,377,86,253,0,29,0,9,17,"-095.2163750","+29.8208000"
"242","482012324052","48",NA,"2",NA,1926,738,1188,1161,187,774,0,191,0,9,27,2466,1036,1430,1403,205,953,3,233,0,9,27,"-095.1726902","+29.8124894"
"243","482012324053","48",NA,"3",NA,1201,603,598,580,40,470,1,67,0,2,18,1615,863,752,727,40,592,3,89,0,3,25,"-095.1921157","+29.8210792"
"244","482012325001","48",NA,"1",NA,1090,982,108,105,74,24,1,5,1,0,3,1423,1293,130,122,78,32,1,7,1,3,8,"-095.2502681","+29.8059971"
"245","482012325002","48",NA,"2",NA,1325,575,750,733,382,338,2,5,2,4,17,1734,860,874,850,389,443,2,9,2,5,24,"-095.2297705","+29.8077716"
"246","482012326001","48",NA,"1",NA,1018,822,196,185,153,28,4,0,0,0,11,1316,1099,217,201,162,34,4,1,0,0,16,"-095.2560703","+29.7829809"
"247","482012326002","48",NA,"2",NA,1177,894,283,274,147,119,0,5,0,3,9,1576,1240,336,323,165,139,0,16,0,3,13,"-095.2407436","+29.7824298"
"248","482012327011","48",NA,"1",NA,908,505,403,395,18,367,0,9,0,1,8,1382,803,579,568,29,523,0,10,0,6,11,"-095.2257027","+29.7795279"
"249","482012327012","48",NA,"2",NA,1384,873,511,493,85,395,0,4,0,9,18,1829,1236,593,571,99,458,0,5,0,9,22,"-095.2256828","+29.7845865"
"250","482012327013","48",NA,"3",NA,724,493,231,220,23,195,0,0,0,2,11,1054,735,319,308,31,269,4,1,0,3,11,"-095.2291452","+29.7924342"
"251","482012327014","48",NA,"4",NA,1319,1089,230,223,44,146,0,33,0,0,7,2066,1746,320,310,61,208,0,41,0,0,10,"-095.2196206","+29.7772020"
"252","482012327015","48",NA,"5",NA,470,423,47,39,7,30,0,1,0,1,8,735,651,84,75,14,57,0,3,0,1,9,"-095.2216253","+29.7769124"
"253","482012327031","48",NA,"1",NA,584,506,78,75,19,39,0,9,0,8,3,862,758,104,96,25,54,0,9,0,8,8,"-095.2194006","+29.7743723"
"254","482012327032","48",NA,"2",NA,1268,874,394,384,49,319,1,11,0,4,10,1878,1316,562,547,70,455,1,13,0,8,15,"-095.2219755","+29.7731385"
"255","482012327041","48",NA,"1",NA,608,375,233,217,128,77,0,5,0,7,16,810,538,272,254,136,106,0,5,0,7,18,"-095.2118128","+29.7977850"
"256","482012327042","48",NA,"2",NA,928,429,499,484,146,336,0,2,0,0,15,1199,583,616,595,174,416,2,2,0,1,21,"-095.2141895","+29.7769540"
"257","482012328011","48",NA,"1",NA,816,387,429,416,68,321,0,23,0,4,13,1090,524,566,549,85,435,1,24,0,4,17,"-095.2006192","+29.7890254"
"258","482012328012","48",NA,"2",NA,1184,603,581,578,98,426,5,46,0,3,3,1531,819,712,704,110,539,6,46,0,3,8,"-095.1983573","+29.7880273"
"259","482012328021","48",NA,"1",NA,533,283,250,237,31,199,0,5,0,2,13,769,418,351,333,36,290,0,5,0,2,18,"-095.2051395","+29.7887433"
"260","482012328022","48",NA,"2",NA,1456,846,610,581,80,432,3,60,0,6,29,1946,1207,739,706,98,532,3,61,0,12,33,"-095.2099313","+29.7830037"
"261","482012329011","48",NA,"1",NA,1240,423,817,804,122,656,0,22,0,4,13,1785,636,1149,1124,136,958,0,26,0,4,25,"-095.1971498","+29.7943361"
"262","482012329012","48",NA,"2",NA,1780,775,1005,952,253,607,1,88,1,2,53,2207,1037,1170,1099,277,723,1,95,1,2,71,"-095.1968269","+29.8034755"
"263","482012329021","48",NA,"1",NA,1400,725,675,641,163,425,8,39,0,6,34,1902,1035,867,807,196,545,8,52,0,6,60,"-095.1898878","+29.7979368"
"264","482012329022","48",NA,"2",NA,1710,706,1004,992,158,779,0,46,7,2,12,2478,1061,1417,1396,187,1149,2,49,7,2,21,"-095.1846155","+29.8027619"
"265","482012330011","48",NA,"1",NA,1172,562,610,582,342,225,0,13,1,1,28,1578,807,771,730,411,297,0,13,1,8,41,"-095.1809224","+29.7980333"
"266","482012330012","48",NA,"2",NA,807,386,421,413,55,358,0,0,0,0,8,1189,607,582,569,64,500,0,1,0,4,13,"-095.1850042","+29.7928345"
"267","482012330013","48",NA,"3",NA,940,317,623,613,97,505,0,6,1,4,10,1396,491,905,893,121,752,0,13,1,6,12,"-095.1856709","+29.7964669"
"268","482012330021","48",NA,"1",NA,1479,648,831,801,166,547,3,80,0,5,30,1886,910,976,940,186,648,3,97,0,6,36,"-095.1710913","+29.8037488"
"269","482012330022","48",NA,"2",NA,1599,831,768,740,264,434,15,19,0,8,28,2154,1241,913,879,306,518,16,25,0,14,34,"-095.1688868","+29.7988320"
"270","482012330031","48",NA,"1",NA,1135,677,458,446,343,84,3,15,0,1,12,1554,1018,536,510,391,96,3,15,2,3,26,"-095.1747366","+29.7941183"
"271","482012330032","48",NA,"2",NA,683,387,296,292,218,67,2,5,0,0,4,916,585,331,325,239,78,2,5,0,1,6,"-095.1661345","+29.7931523"
"272","482012331011","48",NA,"1",NA,948,860,88,85,59,23,0,3,0,0,3,1440,1334,106,96,68,24,0,4,0,0,10,"-095.1729604","+29.7851626"
"273","482012331012","48",NA,"2",NA,1685,1320,365,337,179,136,1,20,0,1,28,2448,1999,449,416,211,174,1,28,0,2,33,"-095.1830035","+29.7878651"
"274","482012331013","48",NA,"3",NA,526,380,146,142,109,27,1,5,0,0,4,752,582,170,165,122,37,1,5,0,0,5,"-095.1746543","+29.7896883"
"275","482012331031","48",NA,"1",NA,877,767,110,101,83,11,0,5,0,2,9,1326,1167,159,148,109,31,0,6,0,2,11,"-095.1793667","+29.7738089"
"276","482012331032","48",NA,"2",NA,940,826,114,104,63,27,5,5,0,4,10,1357,1225,132,121,68,35,5,9,0,4,11,"-095.1727111","+29.7738781"
"277","482012331033","48",NA,"3",NA,856,750,106,102,87,1,0,14,0,0,4,1349,1222,127,123,106,3,0,14,0,0,4,"-095.1728096","+29.7795956"
"278","482012331034","48",NA,"4",NA,979,822,157,147,78,40,0,29,0,0,10,1443,1265,178,164,90,45,0,29,0,0,14,"-095.1795263","+29.7794981"
"279","482012331041","48",NA,"1",NA,1050,971,79,75,55,14,4,2,0,0,4,1520,1428,92,88,64,17,5,2,0,0,4,"-095.1661707","+29.7740011"
"280","482012331042","48",NA,"2",NA,1027,895,132,131,114,17,0,0,0,0,1,1590,1405,185,179,148,30,0,0,0,1,6,"-095.1663888","+29.7797269"
"281","482012331051","48",NA,"1",NA,981,845,136,134,112,20,1,1,0,0,2,1488,1327,161,159,133,23,1,1,0,1,2,"-095.1609948","+29.7760789"
"282","482012331052","48",NA,"2",NA,1464,1230,234,230,195,31,4,0,0,0,4,2246,1941,305,292,240,39,4,1,0,8,13,"-095.1665541","+29.7864006"
"283","482012332001","48",NA,"1",NA,1177,870,307,303,253,41,0,7,0,2,4,1641,1281,360,356,284,61,0,7,0,4,4,"-095.1961514","+29.7841844"
"284","482012332002","48",NA,"2",NA,1110,837,273,263,234,23,0,5,0,1,10,1612,1288,324,312,261,44,1,5,0,1,12,"-095.1944296","+29.7782977"
"285","482012332003","48",NA,"3",NA,1143,936,207,201,124,62,0,14,0,1,6,1670,1405,265,253,158,78,0,14,0,3,12,"-095.1875498","+29.7758252"
"286","482012332004","48",NA,"4",NA,1118,954,164,157,128,22,0,4,0,3,7,1538,1339,199,189,147,34,1,4,0,3,10,"-095.1872088","+29.7848508"
"287","482012333001","48",NA,"1",NA,748,677,71,64,48,15,0,1,0,0,7,1035,954,81,73,57,15,0,1,0,0,8,"-095.1959677","+29.7526257"
"288","482012333002","48",NA,"2",NA,1401,1262,139,135,95,15,10,15,0,0,4,2002,1846,156,148,105,15,13,15,0,0,8,"-095.2190596","+29.7654389"
"289","482012333003","48",NA,"3",NA,1026,924,102,100,60,36,1,2,1,0,2,1431,1296,135,131,74,50,4,2,1,0,4,"-095.2089813","+29.7655718"
"290","482012334001","48",NA,"1",NA,814,723,91,84,73,9,0,2,0,0,7,1152,1050,102,94,79,12,0,2,0,1,8,"-095.2338017","+29.7702013"
"291","482012334002","48",NA,"2",NA,1107,790,317,296,95,199,0,2,0,0,21,1414,1062,352,328,100,223,3,2,0,0,24,"-095.2535413","+29.7707059"
"292","482012335011","48",NA,"1",NA,1164,1061,103,93,73,10,1,7,0,2,10,1599,1480,119,109,86,13,1,7,0,2,10,"-095.2412005","+29.7654294"
"293","482012335012","48",NA,"2",NA,1562,1230,332,307,252,35,5,9,0,6,25,2103,1752,351,323,267,36,5,9,0,6,28,"-095.2282753","+29.7623843"
"294","482012335021","48",NA,"1",NA,1336,1205,131,128,111,13,0,1,0,3,3,1828,1678,150,143,121,18,0,1,0,3,7,"-095.2397032","+29.7614556"
"295","482012335022","48",NA,"2",NA,1119,986,133,125,114,4,3,1,0,3,8,1518,1335,183,171,160,4,3,1,0,3,12,"-095.2516407","+29.7635737"
"296","482012336001","48",NA,"1",NA,942,364,578,558,23,525,0,3,0,7,20,1286,586,700,672,28,634,0,3,0,7,28,"-095.2608640","+29.7564963"
"297","482012336002","48",NA,"2",NA,842,343,499,487,34,444,0,7,1,1,12,1138,535,603,587,34,544,0,7,1,1,16,"-095.2608181","+29.7392791"
"298","482012337011","48",NA,"1",NA,1905,1245,660,649,187,441,6,1,1,13,11,2683,1851,832,811,230,558,7,1,1,14,21,"-095.2467760","+29.7348773"
"299","482012337012","48",NA,"2",NA,1784,1590,194,190,167,14,5,1,1,2,4,2488,2262,226,220,187,23,5,2,1,2,6,"-095.2435356","+29.7398172"
"300","482012337021","48",NA,"1",NA,872,798,74,68,67,1,0,0,0,0,6,1290,1198,92,82,73,3,0,0,0,6,10,"-095.2383535","+29.7511304"
"301","482012337022","48",NA,"2",NA,1127,1011,116,107,88,12,0,4,0,3,9,1642,1490,152,139,110,20,0,4,0,5,13,"-095.2365310","+29.7364775"
"302","482012337031","48",NA,"1",NA,1078,901,177,168,158,8,2,0,0,0,9,1466,1277,189,179,168,8,2,0,0,1,10,"-095.2215425","+29.7434920"
"303","482012337032","48",NA,"2",NA,800,715,85,79,66,9,0,2,0,2,6,1189,1075,114,105,90,10,0,2,0,3,9,"-095.2317173","+29.7386697"
"304","482012401011","48",NA,"1",NA,1288,1057,231,222,55,150,0,14,1,2,9,1991,1664,327,308,80,197,1,19,1,10,19,"-095.3917008","+29.9427937"
"305","482012401021","48",NA,"1",NA,894,319,575,556,34,512,2,8,0,0,19,1240,452,788,769,36,716,7,10,0,0,19,"-095.4053762","+29.9485170"
"306","482012401022","48",NA,"2",NA,446,280,166,150,102,41,6,0,0,1,16,595,407,188,168,109,48,7,3,0,1,20,"-095.4104973","+29.9474154"
"307","482012404001","48",NA,"1",NA,615,515,100,95,68,18,0,5,1,3,5,930,812,118,108,73,26,0,5,1,3,10,"-095.3760774","+29.9507329"
"308","482012404002","48",NA,"2",NA,2203,1007,1196,1151,385,648,0,100,15,3,45,2887,1410,1477,1421,426,849,0,126,17,3,56,"-095.3922332","+30.0144858"
"309","482012404003","48",NA,"3",NA,1729,859,870,835,354,388,7,60,16,10,35,2296,1229,1067,1019,406,505,10,72,16,10,48,"-095.3789633","+29.9953543"
"310","482012404004","48",NA,"4",NA,1319,615,704,693,90,582,0,16,0,5,11,1871,869,1002,983,108,847,1,19,0,8,19,"-095.3677557","+29.9542845"
"311","482012405031","48",NA,"1",NA,570,411,159,150,15,134,0,0,0,1,9,862,647,215,199,20,177,0,1,0,1,16,"-095.3907639","+29.9488969"
"312","482012405032","48",NA,"2",NA,720,318,402,384,27,342,1,5,2,7,18,1060,475,585,551,33,497,1,6,2,12,34,"-095.3880703","+29.9501245"
"313","482012405041","48",NA,"1",NA,921,503,418,410,30,371,3,6,0,0,8,1338,769,569,547,44,492,3,6,2,0,22,"-095.3920741","+29.9468823"
"314","482012405042","48",NA,"2",NA,785,279,506,498,60,408,0,25,0,5,8,1078,415,663,649,62,537,0,39,0,11,14,"-095.3964326","+29.9489173"
"315","482012405043","48",NA,"3",NA,643,274,369,366,25,340,0,0,1,0,3,905,373,532,523,26,492,0,0,5,0,9,"-095.3954373","+29.9500175"
"316","482012405051","48",NA,"1",NA,473,248,225,215,17,194,0,2,0,2,10,697,362,335,306,22,276,0,2,2,4,29,"-095.3965443","+29.9510306"
"317","482012405052","48",NA,"2",NA,531,269,262,257,20,232,0,5,0,0,5,786,415,371,360,23,328,0,7,0,2,11,"-095.3940467","+29.9522300"
"318","482012405061","48",NA,"1",NA,960,170,790,772,53,706,0,1,0,12,18,1316,254,1062,1043,61,964,0,1,0,17,19,"-095.3904202","+29.9544156"
"319","482012405062","48",NA,"2",NA,1462,945,517,491,46,437,0,6,0,2,26,2296,1510,786,742,66,661,7,6,0,2,44,"-095.3902644","+29.9606991"
"320","482012405063","48",NA,"3",NA,986,795,191,190,33,140,0,11,0,6,1,1462,1195,267,266,57,191,1,11,0,6,1,"-095.3967414","+29.9555797"
"321","482012406001","48",NA,"1",NA,648,314,334,327,48,273,0,6,0,0,7,985,494,491,475,54,412,0,9,0,0,16,"-095.4015720","+29.9494659"
"322","482012406002","48",NA,"2",NA,480,303,177,169,13,156,0,0,0,0,8,734,507,227,214,15,197,0,0,0,2,13,"-095.3977138","+29.9466967"
"323","482012406003","48",NA,"3",NA,471,278,193,187,22,155,3,4,2,1,6,739,455,284,274,32,229,3,4,2,4,10,"-095.4088675","+29.9591871"
"324","482012407031","48",NA,"1",NA,730,204,526,511,118,375,0,14,1,3,15,912,249,663,638,123,493,0,18,1,3,25,"-095.4223327","+30.0014718"
"325","482012407032","48",NA,"2",NA,1336,867,469,454,89,309,0,46,0,10,15,1856,1255,601,570,104,398,0,51,0,17,31,"-095.4136395","+30.0031555"
"326","482012407033","48",NA,"3",NA,1631,837,794,749,50,655,0,44,0,0,45,2376,1292,1084,1022,61,901,0,58,1,1,62,"-095.4055418","+29.9987317"
"327","482012407041","48",NA,"1",NA,1948,1199,749,734,123,520,3,83,0,5,15,2752,1717,1035,1009,150,743,3,98,0,15,26,"-095.4189808","+30.0107426"
"328","482012407042","48",NA,"2",NA,938,529,409,395,87,274,2,26,1,5,14,1285,749,536,522,107,371,6,29,3,6,14,"-095.4170392","+30.0060351"
"329","482012407043","48",NA,"3",NA,701,126,575,564,53,506,0,3,1,1,11,1055,175,880,858,63,782,0,8,1,4,22,"-095.4242598","+30.0155196"
"330","482012407051","48",NA,"1",NA,1757,1279,478,465,42,393,1,27,0,2,13,2621,1915,706,672,66,569,3,29,0,5,34,"-095.4078231","+30.0057500"
"331","482012407052","48",NA,"2",NA,2254,1254,1000,957,99,812,4,40,0,2,43,3478,2012,1466,1401,131,1201,5,52,2,10,65,"-095.4102398","+30.0167674"
"332","482012407061","48",NA,"1",NA,1794,888,906,878,110,695,1,63,0,9,28,2697,1368,1329,1279,140,1053,1,69,0,16,50,"-095.4054635","+29.9786806"
"333","482012407062","48",NA,"2",NA,2390,1364,1026,1000,112,811,0,65,1,11,26,3611,2103,1508,1466,147,1216,0,86,1,16,42,"-095.3950496","+29.9729531"
"334","482012407063","48",NA,"3",NA,2406,1702,704,677,118,515,11,27,2,4,27,3663,2690,973,924,140,727,11,33,3,10,49,"-095.4027577","+29.9891602"
"335","482012407071","48",NA,"1",NA,1551,823,728,709,72,524,0,102,4,7,19,2338,1271,1067,1027,103,766,1,139,6,12,40,"-095.4171976","+29.9863584"
"336","482012407072","48",NA,"2",NA,1276,763,513,492,72,369,1,43,2,5,21,1920,1157,763,734,95,579,5,48,2,5,29,"-095.4128391","+29.9692307"
"337","482012407073","48",NA,"3",NA,1510,873,637,615,73,459,0,69,5,9,22,2243,1321,922,889,111,668,0,89,5,16,33,"-095.4072003","+29.9721395"
"338","482012408021","48",NA,"1",NA,1998,766,1232,1146,323,742,1,63,11,6,86,2872,1181,1691,1580,371,1103,1,84,15,6,111,"-095.3564617","+30.0243765"
"339","482012408022","48",NA,"2",NA,2024,648,1376,1345,154,1148,2,24,12,5,31,3172,1065,2107,2054,185,1814,2,35,12,6,53,"-095.3837999","+30.0298955"
"340","482012408023","48",NA,"3",NA,721,299,422,397,215,164,5,8,5,0,25,989,444,545,498,246,233,5,8,5,1,47,"-095.3992662","+30.0307989"
"341","482012408024","48",NA,"4",NA,314,27,287,282,6,271,0,4,1,0,5,507,42,465,457,14,438,0,4,1,0,8,"-095.3714846","+30.0155439"
"342","482012408031","48",NA,"1",NA,1013,449,564,550,222,290,7,21,7,3,14,1407,664,743,719,258,412,7,25,7,10,24,"-095.4173916","+30.0304915"
"343","482012408032","48",NA,"2",NA,1070,376,694,668,328,305,4,21,6,4,26,1399,538,861,821,336,444,4,26,6,5,40,"-095.4116289","+30.0293691"
"344","482012408041","48",NA,"1",NA,700,320,380,364,61,293,0,10,0,0,16,946,457,489,469,65,389,0,10,3,2,20,"-095.4227545","+30.0268706"
"345","482012408042","48",NA,"2",NA,762,459,303,295,64,216,2,11,0,2,8,1094,634,460,444,83,330,3,20,0,8,16,"-095.4258750","+30.0251877"
"346","482012408043","48",NA,"3",NA,880,405,475,458,86,354,1,9,0,8,17,1247,587,660,635,97,512,4,10,0,12,25,"-095.4251802","+30.0303253"
"347","482012409031","48",NA,"1",NA,1728,716,1012,978,250,648,5,36,29,10,34,2483,1073,1410,1353,300,947,7,44,42,13,57,"-095.3012994","+30.0186445"
"348","482012409032","48",NA,"2",NA,2753,1060,1693,1638,369,1116,9,108,22,14,55,4007,1643,2364,2278,441,1632,9,134,38,24,86,"-095.3003066","+30.0272748"
"349","482012409041","48",NA,"1",NA,953,364,589,566,384,119,2,54,2,5,23,1202,521,681,653,430,156,2,58,2,5,28,"-095.2726596","+30.0193363"
"350","482012409042","48",NA,"2",NA,3437,1271,2166,2108,463,1426,29,151,27,12,58,4654,1877,2777,2679,530,1888,30,177,38,16,98,"-095.2918685","+30.0120188"
"351","482012409043","48",NA,"3",NA,1313,576,737,715,188,460,0,53,11,3,22,1788,832,956,915,207,631,0,56,18,3,41,"-095.3007036","+30.0139697"
"352","482012409044","48",NA,"4",NA,1194,542,652,631,267,326,0,35,0,3,21,1630,817,813,775,322,413,0,36,1,3,38,"-095.3024025","+30.0082837"
"353","482012409051","48",NA,"1",NA,2165,1000,1165,1128,323,671,6,89,29,10,37,3011,1480,1531,1492,383,942,7,109,38,13,39,"-095.3121376","+30.0105315"
"354","482012409052","48",NA,"2",NA,617,281,336,321,139,158,1,15,2,6,15,864,419,445,422,162,231,1,17,2,9,23,"-095.3258638","+30.0132084"
"355","482012409061","48",NA,"1",NA,1735,625,1110,1071,206,753,3,86,12,11,39,2439,960,1479,1423,253,1021,3,109,23,14,56,"-095.3231396","+30.0251748"
"356","482012409062","48",NA,"2",NA,1853,795,1058,1007,199,708,3,68,21,8,51,2681,1191,1490,1416,247,1050,3,79,23,14,74,"-095.3085948","+30.0298968"
"357","482012409063","48",NA,"3",NA,2120,884,1236,1184,203,895,0,58,24,4,52,3103,1354,1749,1677,250,1309,0,62,47,9,72,"-095.3152277","+30.0254156"
"358","482012410011","48",NA,"1",NA,1062,439,623,602,367,205,1,23,1,5,21,1594,724,870,828,440,345,1,31,1,10,42,"-095.3479827","+30.0361181"
"359","482012410012","48",NA,"2",NA,657,254,403,379,240,111,3,16,1,8,24,882,383,499,466,268,167,3,17,3,8,33,"-095.3421007","+30.0427645"
"360","482012410013","48",NA,"3",NA,1646,586,1060,995,521,412,4,48,6,4,65,2253,883,1370,1283,644,569,5,55,6,4,87,"-095.3380706","+30.0357213"
"361","482012410021","48",NA,"1",NA,1233,407,826,778,476,251,3,37,1,10,48,1653,576,1077,990,563,360,3,42,1,21,87,"-095.3374648","+30.0560607"
"362","482012410022","48",NA,"2",NA,1834,764,1070,1026,725,247,3,36,6,9,44,2452,1096,1356,1270,849,355,4,42,6,14,86,"-095.3311585","+30.0406993"
"363","482012411011","48",NA,"1",NA,1818,635,1183,1120,697,359,1,49,10,4,63,2464,937,1527,1438,840,523,1,54,14,6,89,"-095.3815785","+30.0650315"
"364","482012411012","48",NA,"2",NA,1883,790,1093,1029,674,295,6,32,3,19,64,2573,1142,1431,1333,807,455,8,41,3,19,98,"-095.3936899","+30.0609083"
"365","482012411031","48",NA,"1",NA,1383,527,856,821,418,356,8,23,4,12,35,1865,730,1135,1068,480,531,8,32,4,13,67,"-095.3789293","+30.0508225"
"366","482012411032","48",NA,"2",NA,950,314,636,608,327,247,5,20,5,4,28,1297,477,820,778,373,354,5,32,9,5,42,"-095.3832036","+30.0474119"
"367","482012411033","48",NA,"3",NA,823,368,455,433,160,244,0,25,2,2,22,1214,555,659,598,192,369,0,29,2,6,61,"-095.3758706","+30.0406317"
"368","482012411041","48",NA,"1",NA,2308,767,1541,1477,474,866,2,116,11,8,64,3332,1203,2129,2022,591,1254,2,144,12,19,107,"-095.3720621","+30.0643665"
"369","482012411042","48",NA,"2",NA,1283,544,739,678,363,285,3,23,4,0,61,1848,834,1014,940,454,440,3,29,11,3,74,"-095.3533306","+30.0464795"
"370","482012411043","48",NA,"3",NA,1488,591,897,862,377,454,1,16,6,8,35,2053,839,1214,1161,446,666,2,30,9,8,53,"-095.3725573","+30.0564648"
"371","482012411044","48",NA,"4",NA,1449,626,823,783,355,383,7,16,1,21,40,2061,921,1140,1084,448,582,7,16,1,30,56,"-095.3599042","+30.0540199"
"372","482012411051","48",NA,"1",NA,1012,461,551,521,315,191,2,6,4,3,30,1463,716,747,699,388,291,4,9,4,3,48,"-095.3641619","+30.0449510"
"373","482012411052","48",NA,"2",NA,1128,425,703,678,333,297,2,33,2,11,25,1596,659,937,892,404,432,4,38,2,12,45,"-095.3631228","+30.0402624"
"374","482012411053","48",NA,"3",NA,1234,505,729,691,420,247,0,14,6,4,38,1754,766,988,927,506,393,1,14,8,5,61,"-095.3692834","+30.0485285"
"375","482012412011","48",NA,"1",NA,1275,387,888,836,460,337,13,21,5,0,52,1799,606,1193,1124,536,539,13,27,9,0,69,"-095.3909830","+30.0425002"
"376","482012412012","48",NA,"2",NA,1163,485,678,650,439,189,3,14,5,0,28,1570,698,872,825,520,264,3,18,11,9,47,"-095.3963537","+30.0418471"
"377","482012412021","48",NA,"1",NA,2065,791,1274,1195,666,452,4,64,3,6,79,2807,1173,1634,1518,759,654,4,80,12,9,116,"-095.3955611","+30.0504425"
"378","482012412022","48",NA,"2",NA,1876,614,1262,1208,380,744,0,72,0,12,54,2638,901,1737,1659,479,1070,0,85,5,20,78,"-095.4026727","+30.0431460"
"379","482012413011","48",NA,"1",NA,1384,355,1029,987,519,347,7,96,2,16,42,1772,500,1272,1209,622,444,7,115,2,19,63,"-095.4280325","+30.0979374"
"380","482012413012","48",NA,"2",NA,1520,504,1016,970,373,523,5,65,2,2,46,2123,773,1350,1281,477,711,6,80,2,5,69,"-095.4287896","+30.0882645"
"381","482012413013","48",NA,"3",NA,1215,342,873,838,496,261,2,69,4,6,35,1581,506,1075,1025,571,351,2,89,4,8,50,"-095.4209779","+30.0760339"
"382","482012413021","48",NA,"1",NA,572,161,411,401,153,173,4,71,0,0,10,713,205,508,494,178,231,4,81,0,0,14,"-095.4278181","+30.0484284"
"383","482012413022","48",NA,"2",NA,1542,473,1069,1021,420,395,6,172,12,16,48,2004,630,1374,1298,496,534,12,214,20,22,76,"-095.4291646","+30.0606695"
"384","482012413023","48",NA,"3",NA,1604,362,1242,1183,714,340,1,119,0,9,59,2067,519,1548,1469,831,474,1,149,0,14,79,"-095.4162491","+30.0584637"
"385","482012413024","48",NA,"4",NA,1555,561,994,955,561,328,3,52,0,11,39,2111,825,1286,1221,627,502,3,72,6,11,65,"-095.4205396","+30.0412875"
"386","482012414001","48",NA,"1",NA,2323,637,1686,1589,1357,173,5,19,18,17,97,2989,965,2024,1907,1582,245,6,20,37,17,117,"-095.4008682","+30.0745165"
"387","482012414002","48",NA,"2",NA,2875,751,2124,2032,1266,613,4,116,12,21,92,3709,1120,2589,2452,1478,797,4,128,13,32,137,"-095.4183463","+30.1029096"
"388","482012414003","48",NA,"3",NA,2251,724,1527,1417,623,617,7,150,8,12,110,3123,1051,2072,1902,774,881,10,202,13,22,170,"-095.3883902","+30.0743100"
"389","482012415011","48",NA,"1",NA,1402,838,564,532,124,388,1,14,1,4,32,1929,1251,678,637,135,477,1,17,1,6,41,"-095.2891756","+29.9659095"
"390","482012415012","48",NA,"2",NA,939,336,603,591,112,404,1,52,18,4,12,1303,503,800,779,138,547,1,67,22,4,21,"-095.2833275","+30.0031965"
"391","482012415013","48",NA,"3",NA,1242,273,969,927,287,555,4,62,14,5,42,1500,363,1137,1085,302,685,4,70,16,8,52,"-095.2855718","+29.9931154"
"392","482012415021","48",NA,"1",NA,746,120,626,619,10,587,3,6,13,0,7,1177,177,1000,991,17,945,3,11,15,0,9,"-095.2948525","+29.9505487"
"393","482012415022","48",NA,"2",NA,764,431,333,316,81,208,3,11,9,4,17,1172,681,491,466,93,336,6,16,11,4,25,"-095.2992038","+29.9455513"
"394","482012415031","48",NA,"1",NA,498,394,104,96,83,9,0,1,0,3,8,721,595,126,118,99,11,0,5,0,3,8,"-095.3728291","+29.9432728"
"395","482012415032","48",NA,"2",NA,1584,1017,567,555,121,384,0,37,0,13,12,1999,1175,824,805,133,620,0,37,2,13,19,"-095.3179814","+29.9466045"
"396","482012501011","48",NA,"1",NA,980,344,636,603,365,208,0,25,2,3,33,1242,493,749,705,403,271,0,26,2,3,44,"-095.2716633","+29.9736015"
"397","482012501012","48",NA,"2",NA,792,357,435,423,179,229,0,9,6,0,12,1068,538,530,511,197,294,0,14,6,0,19,"-095.2811432","+29.9604800"
"398","482012501013","48",NA,"3",NA,1524,706,818,803,266,465,2,56,11,3,15,2051,1023,1028,999,314,603,2,60,14,6,29,"-095.2777935","+29.9527322"
"399","482012501021","48",NA,"1",NA,1037,771,266,244,163,70,0,8,3,0,22,1574,1270,304,276,183,78,0,8,3,4,28,"-095.2600370","+29.9647344"
"400","482012501022","48",NA,"2",NA,2666,1215,1451,1385,315,953,11,76,20,10,66,3995,1885,2110,2013,429,1418,12,100,26,28,97,"-095.2384391","+29.9730267"
"401","482012502011","48",NA,"1",NA,822,259,563,555,90,417,4,37,2,5,8,1207,396,811,783,117,607,4,45,2,8,28,"-095.2624980","+29.9433590"
"402","482012502012","48",NA,"2",NA,1802,630,1172,1136,173,867,6,78,0,12,36,2557,944,1613,1567,225,1225,6,93,0,18,46,"-095.2533677","+29.9406841"
"403","482012502013","48",NA,"3",NA,1357,872,485,481,116,359,0,6,0,0,4,2156,1419,737,729,139,583,0,6,1,0,8,"-095.2570985","+29.9564057"
"404","482012502014","48",NA,"4",NA,1457,960,497,467,210,222,1,9,20,5,30,2126,1478,648,601,257,294,1,10,29,10,47,"-095.2569333","+29.9501906"
"405","482012502021","48",NA,"1",NA,1550,689,861,836,165,583,2,27,53,6,25,2205,1051,1154,1116,186,802,2,27,88,11,38,"-095.2714963","+29.9451501"
"406","482012503031","48",NA,"1",NA,2450,575,1875,1839,328,1351,13,129,2,16,36,3360,835,2525,2466,391,1851,15,182,2,25,59,"-095.2393538","+29.9433313"
"407","482012503041","48",NA,"1",NA,2106,873,1233,1196,307,796,11,63,18,1,37,3269,1433,1836,1764,395,1264,11,74,19,1,72,"-095.2269447","+29.9703257"
"408","482012503042","48",NA,"2",NA,2556,1093,1463,1383,310,982,3,65,5,18,80,3672,1654,2018,1902,376,1391,9,87,15,24,116,"-095.2259299","+29.9400658"
"409","482012503043","48",NA,"3",NA,2302,665,1637,1637,762,863,0,10,0,2,0,2303,666,1637,1637,762,863,0,10,0,2,0,"-095.2351764","+29.9558969"
"410","482012503051","48",NA,"1",NA,2068,665,1403,1345,444,793,4,74,9,21,58,2830,961,1869,1777,549,1092,7,89,10,30,92,"-095.2048775","+29.9811624"
"411","482012503052","48",NA,"2",NA,1312,505,807,769,496,255,3,9,1,5,38,1736,741,995,944,593,331,3,10,1,6,51,"-095.2157830","+29.9736640"
"412","482012503053","48",NA,"3",NA,1098,414,684,661,355,276,2,14,3,11,23,1493,613,880,834,419,377,2,17,3,16,46,"-095.2144555","+29.9661822"
"413","482012503061","48",NA,"1",NA,1320,426,894,859,235,553,2,65,0,4,35,1850,632,1218,1161,319,748,2,86,0,6,57,"-095.2106994","+29.9610827"
"414","482012503062","48",NA,"2",NA,1854,695,1159,1106,315,690,3,97,0,1,53,2816,1128,1688,1597,429,1025,3,136,1,3,91,"-095.2044891","+29.9760963"
"415","482012504031","48",NA,"1",NA,719,192,527,513,315,169,0,29,0,0,14,892,253,639,620,375,215,0,30,0,0,19,"-095.1413955","+30.0094920"
"416","482012504032","48",NA,"2",NA,1439,288,1151,1108,818,227,9,44,5,5,43,1835,416,1419,1354,977,299,9,56,7,6,65,"-095.1397128","+30.0048862"
"417","482012504033","48",NA,"3",NA,1780,385,1395,1332,956,261,11,88,7,9,63,2398,569,1829,1727,1202,368,17,117,7,16,102,"-095.1413554","+29.9970789"
"418","482012504041","48",NA,"1",NA,1606,284,1322,1286,1019,200,6,50,6,5,36,2096,426,1670,1619,1233,296,8,67,10,5,51,"-095.1563893","+29.9878690"
"419","482012504042","48",NA,"2",NA,696,111,585,560,412,116,0,27,0,5,25,960,174,786,727,521,166,1,30,1,8,59,"-095.1586183","+29.9973983"
"420","482012504043","48",NA,"3",NA,1818,337,1481,1402,940,368,16,61,4,13,79,2484,534,1950,1833,1207,495,19,85,7,20,117,"-095.1444816","+29.9858990"
"421","482012504051","48",NA,"1",NA,1864,566,1298,1245,775,383,13,63,0,11,53,2559,839,1720,1639,1015,509,13,86,1,15,81,"-095.1725631","+29.9914455"
"422","482012504052","48",NA,"2",NA,1409,420,989,925,686,183,0,50,0,6,64,1968,651,1317,1223,860,294,0,61,1,7,94,"-095.1647591","+29.9924224"
"423","482012504053","48",NA,"3",NA,2024,633,1391,1348,819,406,0,98,11,14,43,2799,911,1888,1795,1095,535,0,123,14,28,93,"-095.1697602","+29.9844425"
"424","482012504061","48",NA,"1",NA,1606,513,1093,1041,540,429,2,58,4,8,52,2204,730,1474,1392,718,591,2,67,4,10,82,"-095.1917733","+29.9852338"
"425","482012504062","48",NA,"2",NA,1780,373,1407,1367,1028,248,2,68,11,10,40,2575,592,1983,1890,1406,357,4,96,12,15,93,"-095.1834928","+29.9847994"
"426","482012504071","48",NA,"1",NA,775,175,600,568,448,94,0,25,1,0,32,1185,259,926,876,669,161,2,37,1,6,50,"-095.1974902","+29.9695147"
"427","482012504072","48",NA,"2",NA,1872,546,1326,1263,917,263,2,63,5,13,63,2915,902,2013,1894,1368,413,2,88,6,17,119,"-095.2037444","+29.9652400"
"428","482012504073","48",NA,"3",NA,4073,987,3086,2952,2094,692,7,140,6,13,134,6335,1660,4675,4420,3149,1031,8,204,8,20,255,"-095.1853029","+29.9712444"
"429","482012504081","48",NA,"1",NA,6212,1916,4296,4084,1521,2242,9,266,0,46,212,9128,2943,6185,5843,2088,3297,22,364,3,69,342,"-095.1972095","+29.9552365"
"430","482012505001","48",NA,"1",NA,1591,422,1169,1116,749,296,6,62,1,2,53,2137,666,1471,1377,891,400,7,73,1,5,94,"-095.1803084","+29.9954741"
"431","482012505002","48",NA,"2",NA,1127,327,800,767,483,226,4,47,6,1,33,1565,519,1046,997,618,315,4,52,6,2,49,"-095.1936750","+29.9948058"
"432","482012505003","48",NA,"3",NA,1478,360,1118,1079,507,522,0,41,4,5,39,2069,539,1530,1476,638,773,0,53,4,8,54,"-095.2037388","+29.9876704"
"433","482012506011","48",NA,"1",NA,1384,561,823,791,208,464,0,75,43,1,32,1914,767,1147,1103,255,708,0,76,63,1,44,"-095.2711936","+29.9910792"
"434","482012506012","48",NA,"2",NA,1619,492,1127,1057,715,271,10,29,18,14,70,1984,671,1313,1219,791,339,10,39,26,14,94,"-095.2643555","+29.9882075"
"435","482012506021","48",NA,"1",NA,1649,537,1112,1063,435,508,9,50,49,12,49,2232,789,1443,1373,492,735,11,53,68,14,70,"-095.2342099","+29.9888377"
"436","482012506022","48",NA,"2",NA,1737,564,1173,1127,501,585,3,11,13,14,46,2560,825,1735,1664,573,1020,7,15,23,26,71,"-095.2520473","+29.9936705"
"437","482012507011","48",NA,"1",NA,1721,445,1276,1235,838,242,10,130,4,11,41,2479,684,1795,1715,1116,379,12,190,6,12,80,"-095.1857807","+30.0176581"
"438","482012507012","48",NA,"2",NA,1067,266,801,758,517,193,5,21,19,3,43,1411,416,995,933,608,255,6,33,22,9,62,"-095.2300838","+30.0089840"
"439","482012507013","48",NA,"3",NA,1958,722,1236,1175,816,289,10,54,1,5,61,2723,1085,1638,1526,1008,427,13,69,2,7,112,"-095.1956077","+30.0104133"
"440","482012507021","48",NA,"1",NA,1388,324,1064,1018,804,185,7,14,6,2,46,1939,502,1437,1370,1058,263,11,19,6,13,67,"-095.1876776","+30.0026147"
"441","482012507022","48",NA,"2",NA,2258,481,1777,1706,1298,289,2,107,2,8,71,2940,734,2206,2092,1559,396,2,122,2,11,114,"-095.1737120","+30.0035895"
"442","482012508011","48",NA,"1",NA,1325,230,1095,1034,897,107,3,17,2,8,61,1740,338,1402,1316,1133,144,6,21,2,10,86,"-095.1613733","+30.0056203"
"443","482012508012","48",NA,"2",NA,1847,306,1541,1470,1287,112,5,58,2,6,71,2241,419,1822,1721,1489,139,8,70,2,13,101,"-095.1517558","+30.0140464"
"444","482012508021","48",NA,"1",NA,1535,230,1305,1225,1094,50,0,74,4,3,80,2130,381,1749,1646,1467,68,2,96,4,9,103,"-095.1745059","+30.0144472"
"445","482012508022","48",NA,"2",NA,1779,205,1574,1494,1365,58,5,59,4,3,80,2323,328,1995,1872,1708,76,11,68,4,5,123,"-095.1622602","+30.0225516"
"446","482012509011","48",NA,"1",NA,1028,107,921,869,813,43,0,12,0,1,52,1382,164,1218,1136,1070,48,0,16,0,2,82,"-095.1642092","+30.0439916"
"447","482012509012","48",NA,"2",NA,1844,300,1544,1462,1244,157,3,56,0,2,82,2166,396,1770,1667,1388,205,3,64,0,7,103,"-095.1703255","+30.0335840"
"448","482012509021","48",NA,"1",NA,1051,82,969,923,859,29,1,27,0,7,46,1459,139,1320,1235,1151,39,2,34,0,9,85,"-095.1550442","+30.0536372"
"449","482012509022","48",NA,"2",NA,764,71,693,669,639,0,4,24,0,2,24,1050,112,938,906,861,5,6,32,0,2,32,"-095.1479994","+30.0618757"
"450","482012509023","48",NA,"3",NA,1611,114,1497,1451,1360,35,11,44,0,1,46,2189,178,2011,1913,1792,48,14,53,0,6,98,"-095.1481673","+30.0484720"
"451","482012509024","48",NA,"4",NA,1008,62,946,925,867,16,2,36,1,3,21,1329,92,1237,1197,1134,16,2,40,1,4,40,"-095.1378160","+30.0450491"
"452","482012510001","48",NA,"1",NA,1072,110,962,927,875,12,0,36,2,2,35,1342,172,1170,1120,1036,28,0,52,2,2,50,"-095.2075559","+30.0355937"
"453","482012510002","48",NA,"2",NA,708,164,544,526,372,93,0,53,0,8,18,901,231,670,638,437,129,1,61,0,10,32,"-095.1833165","+30.0443789"
"454","482012510003","48",NA,"3",NA,702,94,608,572,499,40,0,27,0,6,36,850,120,730,684,585,54,0,39,0,6,46,"-095.1886074","+30.0346082"
"455","482012511001","48",NA,"1",NA,1143,186,957,924,849,48,1,20,0,6,33,1490,298,1192,1149,1054,59,3,24,0,9,43,"-095.2228687","+30.0460303"
"456","482012511002","48",NA,"2",NA,885,142,743,705,602,63,2,32,0,6,38,1160,206,954,900,754,92,2,43,0,9,54,"-095.2194277","+30.0332553"
"457","482012511003","48",NA,"3",NA,1738,234,1504,1459,1316,53,12,75,0,3,45,2160,343,1817,1745,1561,69,12,92,0,11,72,"-095.2332791","+30.0397770"
"458","482012511004","48",NA,"4",NA,327,57,270,254,243,5,0,3,0,3,16,413,78,335,309,290,9,3,4,0,3,26,"-095.2316201","+30.0271192"
"459","482012511005","48",NA,"5",NA,1565,366,1199,1150,1002,100,10,34,0,4,49,2142,585,1557,1478,1276,144,10,38,0,10,79,"-095.2485603","+30.0365714"
"460","482012512001","48",NA,"1",NA,1207,233,974,928,856,41,0,21,0,10,46,1602,344,1258,1196,1098,57,0,30,0,11,62,"-095.2168588","+30.0638076"
"461","482012512002","48",NA,"2",NA,1184,267,917,898,783,60,2,44,6,3,19,1513,383,1130,1108,955,81,2,59,6,5,22,"-095.2288173","+30.0528268"
"462","482012512003","48",NA,"3",NA,864,163,701,660,598,36,0,23,1,2,41,1172,264,908,848,758,53,0,29,1,7,60,"-095.2220656","+30.0594449"
"463","482012512004","48",NA,"4",NA,1246,310,936,901,795,64,1,32,4,5,35,1700,476,1224,1157,1009,87,3,48,4,6,67,"-095.2181589","+30.0538605"
"464","482012513001","48",NA,"1",NA,1241,233,1008,971,905,39,0,15,0,12,37,1696,362,1334,1275,1180,61,1,20,0,13,59,"-095.1925717","+30.0624385"
"465","482012513002","48",NA,"2",NA,1313,182,1131,1082,1002,40,6,33,0,1,49,1795,304,1491,1416,1321,48,6,35,0,6,75,"-095.2049051","+30.0643188"
"466","482012513003","48",NA,"3",NA,693,96,597,556,517,21,1,9,0,8,41,931,156,775,727,671,30,5,11,0,10,48,"-095.2062320","+30.0611587"
"467","482012513004","48",NA,"4",NA,1360,147,1213,1157,1091,31,5,25,0,5,56,1801,239,1562,1472,1388,38,7,33,0,6,90,"-095.2028972","+30.0496043"
"468","482012513005","48",NA,"5",NA,828,71,757,723,680,21,2,17,0,3,34,1075,129,946,895,848,24,2,17,0,4,51,"-095.1920007","+30.0535400"
"469","482012514011","48",NA,"1",NA,2116,408,1708,1621,1404,88,14,113,0,2,87,3011,664,2347,2191,1897,141,16,135,0,2,156,"-095.1912368","+30.0808776"
"470","482012514021","48",NA,"1",NA,1984,414,1570,1494,1367,82,0,32,2,11,76,2698,639,2059,1928,1750,124,0,37,3,14,131,"-095.2068068","+30.0739942"
"471","482012514022","48",NA,"2",NA,1234,231,1003,963,850,65,1,41,2,4,40,1683,370,1313,1254,1103,95,1,47,4,4,59,"-095.1931421","+30.0724300"
"472","482012514023","48",NA,"3",NA,1134,257,877,840,746,59,0,32,0,3,37,1533,392,1141,1070,935,86,0,38,2,9,71,"-095.1994505","+30.0704625"
"473","482012515011","48",NA,"1",NA,2122,296,1826,1740,1425,77,4,222,2,10,86,3070,465,2605,2450,2013,112,8,300,3,14,155,"-095.1638614","+30.0743762"
"474","482012515012","48",NA,"2",NA,2328,326,2002,1932,1619,102,8,184,2,17,70,3399,546,2853,2701,2273,137,14,247,3,27,152,"-095.1568624","+30.1039803"
"475","482012515031","48",NA,"1",NA,1634,270,1364,1291,1155,47,9,75,0,5,73,2255,407,1848,1732,1550,66,15,90,5,6,116,"-095.1832132","+30.0726664"
"476","482012515041","48",NA,"1",NA,1733,227,1506,1442,1328,53,2,49,0,10,64,2392,352,2040,1940,1771,67,4,84,0,14,100,"-095.1782087","+30.0683778"
"477","482012515042","48",NA,"2",NA,1170,155,1015,980,897,16,6,57,1,3,35,1543,226,1317,1234,1136,27,6,58,4,3,83,"-095.1772906","+30.0621369"
"478","482012515043","48",NA,"3",NA,1012,105,907,866,806,23,3,24,0,10,41,1354,159,1195,1121,1051,26,3,30,0,11,74,"-095.1667589","+30.0652934"
"479","482012515051","48",NA,"1",NA,1024,130,894,856,807,17,8,19,0,5,38,1284,188,1096,1047,976,32,8,26,0,5,49,"-095.1791947","+30.0580853"
"480","482012515052","48",NA,"2",NA,1187,131,1056,1011,972,15,1,14,5,4,45,1600,190,1410,1344,1298,21,1,15,5,4,66,"-095.1632305","+30.0584120"
"481","482012515053","48",NA,"3",NA,716,57,659,636,591,18,3,23,0,1,23,986,102,884,847,780,28,3,35,0,1,37,"-095.1785863","+30.0533549"
"482","482012516001","48",NA,"1",NA,1516,243,1273,1216,1167,18,8,15,0,8,57,2070,377,1693,1606,1540,27,10,19,0,10,87,"-095.0921894","+30.1145231"
"483","482012516002","48",NA,"2",NA,2653,255,2398,2313,2174,81,14,29,0,15,85,3475,396,3079,2959,2788,94,18,38,0,21,120,"-095.1341323","+30.0758298"
"484","482012516003","48",NA,"3",NA,1299,197,1102,1059,1004,30,4,14,0,7,43,1726,309,1417,1354,1284,41,5,15,0,9,63,"-095.1248377","+30.1168576"
"485","482012517011","48",NA,"1",NA,1505,294,1211,1153,1092,32,12,11,1,5,58,2122,464,1658,1550,1475,44,12,13,1,5,108,"-095.0952818","+30.0270353"
"486","482012517012","48",NA,"2",NA,1041,202,839,801,751,22,6,12,0,10,38,1386,304,1082,1019,961,26,6,16,0,10,63,"-095.1029886","+30.0426754"
"487","482012517013","48",NA,"3",NA,1014,138,876,827,794,14,7,12,0,0,49,1384,228,1156,1090,1049,21,7,13,0,0,66,"-095.1182910","+30.0253189"
"488","482012517021","48",NA,"1",NA,1436,233,1203,1152,1064,66,6,14,0,2,51,1985,372,1613,1545,1439,82,6,16,0,2,68,"-095.0749867","+30.0620988"
"489","482012517022","48",NA,"2",NA,1692,320,1372,1305,1157,119,3,16,2,8,67,2315,511,1804,1706,1491,175,3,26,2,9,98,"-095.0757892","+30.0046539"
"490","482012518001","48",NA,"1",NA,1601,415,1186,1118,1049,57,0,6,0,6,68,2096,643,1453,1362,1272,78,0,6,0,6,91,"-095.0333022","+29.9733747"
"491","482012519021","48",NA,"1",NA,1779,430,1349,1273,951,294,5,21,0,2,76,2698,722,1976,1869,1351,482,5,26,0,5,107,"-095.0909920","+29.9019126"
"492","482012519022","48",NA,"2",NA,1650,266,1384,1340,1216,94,4,16,0,10,44,2211,409,1802,1721,1552,126,6,25,0,12,81,"-095.1109677","+29.9156331"
"493","482012519023","48",NA,"3",NA,2139,447,1692,1632,1449,156,7,17,0,3,60,2919,703,2216,2124,1880,207,9,20,0,8,92,"-095.0815985","+29.9174326"
"494","482012519031","48",NA,"1",NA,865,219,646,618,603,12,3,0,0,0,28,1118,328,790,755,729,23,3,0,0,0,35,"-095.0787958","+29.9572284"
"495","482012519032","48",NA,"2",NA,683,141,542,505,475,25,0,1,0,4,37,892,204,688,643,603,30,4,2,0,4,45,"-095.1153320","+29.9866345"
"496","482012519033","48",NA,"3",NA,1911,280,1631,1540,1468,43,8,15,0,6,91,2495,475,2020,1891,1803,51,8,22,1,6,129,"-095.1168280","+29.9581120"
"497","482012519041","48",NA,"1",NA,1043,241,802,759,667,63,9,6,1,13,43,1527,378,1149,1084,953,89,22,6,1,13,65,"-095.0836301","+29.9290075"
"498","482012519042","48",NA,"2",NA,2090,279,1811,1739,1606,112,4,12,0,5,72,2778,416,2362,2238,2059,143,5,14,0,17,124,"-095.1209482","+29.9326670"
"499","482012519043","48",NA,"3",NA,1723,454,1269,1216,1036,136,4,34,0,6,53,2485,746,1739,1664,1427,176,5,44,0,12,75,"-095.0681180","+29.9310792"
"500","482012520011","48",NA,"1",NA,2549,625,1924,1846,834,823,12,163,4,10,78,3380,876,2504,2371,1039,1084,12,218,4,14,133,"-095.1902927","+29.9301487"
"501","482012520012","48",NA,"2",NA,2586,719,1867,1790,748,912,1,118,0,11,77,3706,1132,2574,2440,971,1291,1,161,0,16,134,"-095.1870929","+29.9421567"
"502","482012520021","48",NA,"1",NA,2083,498,1585,1533,809,532,2,178,6,6,52,2998,785,2213,2111,1124,740,2,230,6,9,102,"-095.1763680","+29.9220660"
"503","482012520022","48",NA,"2",NA,1752,667,1085,1021,548,396,4,61,0,12,64,2428,1031,1397,1296,675,529,4,71,0,17,101,"-095.1693923","+29.8906515"
"504","482012520031","48",NA,"1",NA,2016,605,1411,1351,858,371,2,107,1,12,60,2974,967,2007,1885,1161,571,4,132,2,15,122,"-095.1598559","+29.9238061"
"505","482012520032","48",NA,"2",NA,4840,1202,3638,3507,1861,1274,6,347,5,14,131,7012,1944,5068,4844,2568,1758,8,473,5,32,224,"-095.1583943","+29.9630637"
"506","482012520033","48",NA,"3",NA,784,234,550,524,333,151,0,39,1,0,26,1095,359,736,697,435,212,0,49,1,0,39,"-095.1517184","+29.9163117"
"507","482012521001","48",NA,"1",NA,2174,1195,979,919,668,234,1,12,0,4,60,3246,1994,1252,1172,796,354,1,12,2,7,80,"-095.1385243","+29.8850976"
"508","482012522011","48",NA,"1",NA,1113,486,627,615,118,424,0,64,1,8,12,1464,642,822,802,137,564,0,90,1,10,20,"-095.1633005","+29.8189123"
"509","482012522012","48",NA,"2",NA,817,534,283,279,72,196,2,5,1,3,4,1166,779,387,374,97,252,8,10,1,6,13,"-095.1687729","+29.8303156"
"510","482012522013","48",NA,"3",NA,1463,1022,441,422,106,291,3,13,2,7,19,2208,1584,624,586,142,407,3,16,2,16,38,"-095.1621446","+29.8287003"
"511","482012522021","48",NA,"1",NA,1398,949,449,423,251,154,2,15,0,1,26,2025,1481,544,507,295,193,2,16,0,1,37,"-095.1350123","+29.8553158"
"512","482012522022","48",NA,"2",NA,1561,1033,528,502,249,182,2,54,0,15,26,2365,1648,717,685,313,273,2,73,0,24,32,"-095.1714839","+29.8423741"
"513","482012522023","48",NA,"3",NA,1914,1239,675,641,238,270,6,116,0,11,34,2802,1907,895,854,280,392,6,158,0,18,41,"-095.1490398","+29.8329284"
"514","482012523031","48",NA,"1",NA,1105,697,408,388,37,322,4,22,0,3,20,1640,1032,608,584,41,509,4,27,0,3,24,"-095.1451876","+29.7927478"
"515","482012523032","48",NA,"2",NA,1013,666,347,338,70,194,1,68,0,5,9,1448,969,479,468,94,299,1,69,0,5,11,"-095.1478452","+29.7905455"
"516","482012523033","48",NA,"3",NA,1418,922,496,484,88,373,0,22,0,1,12,2044,1371,673,654,103,525,0,25,0,1,19,"-095.1478863","+29.7962912"
"517","482012523041","48",NA,"1",NA,1393,762,631,618,105,461,0,44,0,8,13,2082,1175,907,876,126,695,0,46,0,9,31,"-095.1566038","+29.7939800"
"518","482012523042","48",NA,"2",NA,1113,659,454,446,160,258,0,20,1,7,8,1481,943,538,521,179,309,4,20,1,8,17,"-095.1603033","+29.8025372"
"519","482012523051","48",NA,"1",NA,1268,862,406,399,113,246,2,38,0,0,7,1805,1284,521,505,131,325,2,47,0,0,16,"-095.1451014","+29.8056858"
"520","482012523052","48",NA,"2",NA,1671,1045,626,591,138,367,0,79,1,6,35,2468,1636,832,775,186,479,0,100,1,9,57,"-095.1501605","+29.8099858"
"521","482012523053","48",NA,"3",NA,1015,584,431,419,120,288,0,2,3,6,12,1418,859,559,536,139,383,0,4,3,7,23,"-095.1470550","+29.8016033"
"522","482012523054","48",NA,"4",NA,1552,986,566,558,175,334,1,44,0,4,8,2109,1398,711,691,206,432,1,47,0,5,20,"-095.1542299","+29.8025852"
"523","482012523061","48",NA,"1",NA,827,601,226,208,132,59,0,14,0,3,18,1233,955,278,255,154,74,2,20,0,5,23,"-095.1271978","+29.7936987"
"524","482012523062","48",NA,"2",NA,2757,2019,738,710,207,434,0,55,0,14,28,4218,3218,1000,958,254,622,2,61,0,19,42,"-095.1334087","+29.7998786"
"525","482012523063","48",NA,"3",NA,2248,1623,625,614,105,448,0,56,0,5,11,3492,2658,834,816,145,595,0,70,0,6,18,"-095.1343035","+29.8124407"
"526","482012524001","48",NA,"1",NA,1763,1244,519,503,451,44,1,2,0,5,16,2474,1864,610,584,515,56,1,3,0,9,26,"-095.1329343","+29.7864839"
"527","482012524002","48",NA,"2",NA,1096,724,372,354,295,45,4,6,0,4,18,1508,1067,441,416,347,53,4,7,0,5,25,"-095.1545397","+29.7807979"
"528","482012524003","48",NA,"3",NA,831,444,387,377,334,16,9,15,0,3,10,1138,676,462,440,389,21,9,17,0,4,22,"-095.1380019","+29.7769127"
"529","482012524004","48",NA,"4",NA,1898,1317,581,555,477,63,3,5,1,6,26,2643,1957,686,656,541,92,3,6,1,13,30,"-095.1482175","+29.7851371"
"530","482012525001","48",NA,"1",NA,988,774,214,205,172,17,1,6,0,9,9,1448,1165,283,262,220,19,2,11,0,10,21,"-095.1372138","+29.7587441"
"531","482012525002","48",NA,"2",NA,873,620,253,253,225,11,2,9,0,6,0,1310,984,326,324,288,11,5,13,0,7,2,"-095.1069933","+29.7741245"
"532","482012525003","48",NA,"3",NA,1523,1105,418,408,344,25,10,11,0,18,10,2293,1747,546,527,444,38,10,11,0,24,19,"-095.0848265","+29.7769579"
"533","482012526011","48",NA,"1",NA,2203,1541,662,634,587,31,2,9,2,3,28,3244,2452,792,758,687,52,2,9,4,4,34,"-095.1143317","+29.7879105"
"534","482012526012","48",NA,"2",NA,1089,803,286,273,248,23,1,0,1,0,13,1651,1277,374,353,313,33,1,0,6,0,21,"-095.1184510","+29.7960211"
"535","482012526021","48",NA,"1",NA,970,720,250,238,223,7,3,5,0,0,12,1427,1128,299,284,259,14,3,6,0,2,15,"-095.1120346","+29.8041708"
"536","482012526022","48",NA,"2",NA,836,522,314,307,293,7,1,5,0,1,7,1167,819,348,339,323,9,1,5,0,1,9,"-095.1122938","+29.8422106"
"537","482012526023","48",NA,"3",NA,779,436,343,322,291,8,2,19,0,2,21,1127,714,413,386,345,14,2,22,0,3,27,"-095.0844431","+29.7968107"
"538","482012527001","48",NA,"1",NA,1164,290,874,835,673,151,0,6,2,3,39,1627,473,1154,1087,843,230,0,6,3,5,67,"-095.0461676","+29.9048299"
"539","482012527002","48",NA,"2",NA,1446,642,804,763,706,41,5,7,1,3,41,2076,1037,1039,973,890,62,5,9,1,6,66,"-095.0561110","+29.9126982"
"540","482012527003","48",NA,"3",NA,993,208,785,753,706,34,0,6,0,7,32,1304,341,963,924,864,47,0,6,0,7,39,"-095.0100952","+29.9227392"
"541","482012528001","48",NA,"1",NA,1687,803,884,843,739,96,0,6,0,2,41,2255,1156,1099,1052,911,131,2,6,0,2,47,"-094.9943668","+29.8689451"
"542","482012528002","48",NA,"2",NA,1661,543,1118,1099,255,824,8,3,0,9,19,2318,888,1430,1398,317,1046,19,4,0,12,32,"-095.0705212","+29.8559317"
"543","482012528003","48",NA,"3",NA,2421,888,1533,1484,430,1026,1,16,0,11,49,3451,1492,1959,1893,547,1308,2,21,0,15,66,"-095.0524614","+29.8654152"
"544","482012529011","48",NA,"1",NA,1457,375,1082,1034,952,63,4,9,0,6,48,1891,556,1335,1273,1171,79,4,12,1,6,62,"-095.0741468","+29.8177666"
"545","482012529012","48",NA,"2",NA,1057,341,716,683,630,43,3,6,0,1,33,1372,509,863,807,743,49,6,8,0,1,56,"-095.0735465","+29.8141160"
"546","482012529021","48",NA,"1",NA,2049,844,1205,1142,796,302,3,25,0,16,63,2933,1347,1586,1484,990,440,5,28,0,21,102,"-095.0480851","+29.8018854"
"547","482012529022","48",NA,"2",NA,1330,434,896,845,790,35,10,8,0,2,51,1822,707,1115,1040,950,65,12,10,0,3,75,"-095.0512679","+29.8340342"
"548","482012529023","48",NA,"3",NA,1768,754,1014,978,910,43,10,8,0,7,36,2418,1172,1246,1192,1110,54,10,9,0,9,54,"-095.0460271","+29.8172259"
"549","482012530001","48",NA,"1",NA,649,144,505,489,15,463,7,3,0,1,16,845,234,611,589,22,555,7,3,0,2,22,"-095.0273799","+29.8036334"
"550","482012530002","48",NA,"2",NA,816,297,519,499,103,369,3,19,0,5,20,1190,505,685,659,145,484,3,19,0,8,26,"-095.0188782","+29.8066165"
"551","482012530003","48",NA,"3",NA,560,194,366,358,298,54,2,0,0,4,8,695,271,424,409,337,66,2,0,0,4,15,"-095.0052501","+29.8160495"
"552","482012530004","48",NA,"4",NA,1357,544,813,796,502,279,5,9,0,1,17,1907,855,1052,1028,638,375,5,9,0,1,24,"-095.0250222","+29.8225888"
"553","482012531011","48",NA,"1",NA,1775,745,1030,984,567,360,3,51,0,3,46,2354,1055,1299,1236,706,463,3,57,0,7,63,"-094.9904607","+29.8077531"
"554","482012531012","48",NA,"2",NA,2946,1278,1668,1593,757,672,12,145,4,3,75,4270,2055,2215,2111,990,919,12,183,4,3,104,"-094.9896036","+29.8139933"
"555","482012531021","48",NA,"1",NA,2360,1038,1322,1258,540,521,1,190,0,6,64,3495,1623,1872,1771,761,751,4,235,1,19,101,"-094.9790900","+29.8183048"
"556","482012531022","48",NA,"2",NA,2311,978,1333,1293,615,407,8,239,1,23,40,3556,1605,1951,1872,891,584,10,353,4,30,79,"-094.9611681","+29.8288339"
"557","482012532011","48",NA,"1",NA,1759,581,1178,1130,874,226,14,14,0,2,48,2402,930,1472,1394,1096,267,15,14,0,2,78,"-094.9447096","+29.7971618"
"558","482012532012","48",NA,"2",NA,1607,318,1289,1248,1094,130,3,18,0,3,41,2093,471,1622,1562,1297,237,3,22,0,3,60,"-094.9331070","+29.7753495"
"559","482012532013","48",NA,"3",NA,1429,319,1110,1056,966,72,0,7,2,9,54,1847,508,1339,1255,1157,79,1,7,2,9,84,"-094.9225644","+29.7849332"
"560","482012532021","48",NA,"1",NA,1095,448,647,633,306,274,0,41,0,12,14,1466,625,841,818,367,395,0,41,0,15,23,"-094.9908547","+29.7892346"
"561","482012532022","48",NA,"2",NA,1205,304,901,853,571,237,0,38,0,7,48,1653,506,1147,1071,668,350,0,45,0,8,76,"-094.9727042","+29.7919567"
"562","482012532023","48",NA,"3",NA,863,708,155,145,114,21,0,4,0,6,10,1321,1112,209,197,141,36,0,7,0,13,12,"-095.0095680","+29.7887968"
"563","482012532024","48",NA,"4",NA,621,196,425,405,111,280,0,6,0,8,20,901,280,621,582,133,433,0,6,0,10,39,"-095.0308370","+29.7921228"
"564","482012533001","48",NA,"1",NA,1539,493,1046,1017,870,120,6,17,1,3,29,2013,765,1248,1213,1015,167,6,21,1,3,35,"-095.0383091","+29.7789067"
"565","482012533002","48",NA,"2",NA,1378,471,907,855,784,43,5,13,1,9,52,1823,716,1107,1038,953,54,5,16,1,9,69,"-095.0427303","+29.7672653"
"566","482012535011","48",NA,"1",NA,1249,624,625,594,332,234,3,22,0,3,31,1731,943,788,736,395,310,3,22,0,6,52,"-094.9976548","+29.7780086"
"567","482012535012","48",NA,"2",NA,3712,1190,2522,2440,1240,919,8,247,0,26,82,4821,1650,3171,3035,1449,1234,8,318,0,26,136,"-094.9792596","+29.7752499"
"568","482012535021","48",NA,"1",NA,1110,511,599,589,198,372,2,2,0,15,10,1659,765,894,877,253,605,2,2,0,15,17,"-095.0041714","+29.7741228"
"569","482012535022","48",NA,"2",NA,658,380,278,256,138,116,0,0,0,2,22,970,596,374,338,176,155,0,3,0,4,36,"-095.0109833","+29.7733667"
"570","482012535023","48",NA,"3",NA,756,371,385,373,213,143,0,14,0,3,12,1170,615,555,525,258,232,0,26,0,9,30,"-095.0221010","+29.7834973"
"571","482012536011","48",NA,"1",NA,910,363,547,529,390,113,1,18,0,7,18,1148,521,627,605,438,140,1,18,0,8,22,"-095.0050793","+29.7673596"
"572","482012536012","48",NA,"2",NA,2445,709,1736,1680,1107,387,8,159,0,19,56,3039,1008,2031,1960,1243,482,8,200,0,27,71,"-094.9886192","+29.7652358"
"573","482012536021","48",NA,"1",NA,1135,564,571,548,206,283,3,36,1,19,23,1661,913,748,715,243,394,3,49,2,24,33,"-094.9840287","+29.7582559"
"574","482012536022","48",NA,"2",NA,2133,953,1180,1123,391,611,14,49,4,54,57,3074,1428,1646,1557,484,925,27,49,4,68,89,"-094.9930320","+29.7577255"
"575","482012537001","48",NA,"1",NA,750,478,272,250,151,77,2,10,0,10,22,1082,703,379,345,198,118,2,15,2,10,34,"-094.9750306","+29.7520635"
"576","482012537002","48",NA,"2",NA,1227,520,707,680,406,234,1,33,1,5,27,1670,773,897,857,478,331,1,40,1,6,40,"-094.9679315","+29.7569699"
"577","482012537003","48",NA,"3",NA,1111,456,655,624,327,262,2,33,0,0,31,1499,654,845,800,391,363,2,36,0,8,45,"-094.9677105","+29.7698501"
"578","482012537004","48",NA,"4",NA,1098,297,801,781,519,204,2,38,0,18,20,1329,422,907,873,567,242,3,41,1,19,34,"-094.9744203","+29.7680129"
"579","482012538001","48",NA,"1",NA,1273,547,726,693,364,282,2,41,2,2,33,1829,855,974,926,479,392,4,45,2,4,48,"-094.9598315","+29.7700396"
"580","482012538002","48",NA,"2",NA,1635,713,922,883,695,148,4,21,4,11,39,2173,1035,1138,1078,838,185,10,24,4,17,60,"-094.9486705","+29.7715400"
"581","482012538003","48",NA,"3",NA,1741,1242,499,472,328,122,13,5,0,4,27,2681,2019,662,635,432,175,16,5,0,7,27,"-094.9327401","+29.7628007"
"582","482012538004","48",NA,"4",NA,1520,716,804,775,439,315,7,8,1,5,29,2179,1138,1041,1000,549,418,11,11,1,10,41,"-094.9568319","+29.7588992"
"583","482012539001","48",NA,"1",NA,1391,449,942,908,616,256,0,31,0,5,34,1907,696,1211,1149,738,364,0,38,0,9,62,"-094.9425999","+29.7496778"
"584","482012539002","48",NA,"2",NA,1055,355,700,674,451,206,0,10,0,7,26,1491,532,959,913,564,328,0,10,0,11,46,"-094.9300061","+29.7560438"
"585","482012539003","48",NA,"3",NA,933,396,537,506,414,75,2,9,2,4,31,1236,591,645,597,477,98,4,11,2,5,48,"-094.9434221","+29.7415012"
"586","482012540001","48",NA,"1",NA,1394,571,823,779,446,313,6,4,0,10,44,1995,880,1115,1052,531,489,8,11,0,13,63,"-094.9387813","+29.7357608"
"587","482012540002","48",NA,"2",NA,1495,605,890,855,660,156,7,23,4,5,35,1940,899,1041,974,737,190,9,27,4,7,67,"-094.9487078","+29.7348692"
"588","482012541001","48",NA,"1",NA,1132,500,632,618,387,219,2,3,0,7,14,1598,760,838,818,454,348,3,3,0,10,20,"-094.9504966","+29.7499703"
"589","482012541002","48",NA,"2",NA,634,345,289,262,169,72,4,13,2,2,27,872,498,374,342,225,95,4,13,2,3,32,"-094.9596243","+29.7510195"
"590","482012541003","48",NA,"3",NA,1124,768,356,342,218,92,0,29,0,3,14,1530,1085,445,422,258,128,0,33,0,3,23,"-094.9597740","+29.7428856"
"591","482012541004","48",NA,"4",NA,1026,705,321,311,183,113,4,6,0,5,10,1466,1042,424,402,227,156,4,8,0,7,22,"-094.9593420","+29.7366886"
"592","482012542001","48",NA,"1",NA,610,463,147,133,98,28,3,0,0,4,14,894,693,201,179,127,45,3,0,0,4,22,"-094.9627759","+29.7297410"
"593","482012542002","48",NA,"2",NA,800,550,250,242,180,55,3,1,0,3,8,1082,809,273,264,195,61,4,1,0,3,9,"-094.9662077","+29.7255610"
"594","482012542003","48",NA,"3",NA,687,532,155,144,84,50,0,3,2,5,11,946,747,199,183,100,65,0,3,4,11,16,"-094.9636604","+29.7331085"
"595","482012543001","48",NA,"1",NA,891,570,321,305,219,79,0,3,1,3,16,1232,861,371,351,246,97,0,4,1,3,20,"-094.9678216","+29.7441863"
"596","482012543002","48",NA,"2",NA,866,541,325,301,156,133,4,0,3,5,24,1178,756,422,394,194,187,4,0,3,6,28,"-094.9684728","+29.7374763"
"597","482012543003","48",NA,"3",NA,1258,679,579,558,282,238,5,17,0,16,21,1701,975,726,688,318,325,7,18,0,20,38,"-094.9776756","+29.7428774"
"598","482012543004","48",NA,"4",NA,880,448,432,399,247,135,1,0,0,16,33,1229,705,524,478,288,163,10,0,0,17,46,"-094.9744986","+29.7395222"
"599","482012544001","48",NA,"1",NA,1676,1217,459,443,182,245,1,3,0,12,16,2301,1729,572,533,212,303,1,3,0,14,39,"-094.9779185","+29.7293741"
"600","482012544002","48",NA,"2",NA,553,399,154,140,106,30,0,0,0,4,14,815,601,214,190,135,50,0,0,0,5,24,"-094.9721925","+29.7205372"
"601","482012546001","48",NA,"1",NA,809,627,182,168,97,50,3,7,0,11,14,1112,891,221,206,122,61,3,8,1,11,15,"-094.9979333","+29.7210753"
"602","482012546002","48",NA,"2",NA,932,683,249,227,166,41,4,7,0,9,22,1220,931,289,263,190,50,4,10,0,9,26,"-095.0108385","+29.7154386"
"603","482012546003","48",NA,"3",NA,972,512,460,423,198,200,8,12,0,5,37,1359,763,596,531,226,277,8,15,0,5,65,"-094.9922360","+29.7184330"
"604","482012547001","48",NA,"1",NA,1860,626,1234,1163,911,199,3,35,3,12,71,2428,917,1511,1408,1084,270,3,35,4,12,103,"-094.9581652","+29.7034554"
"605","482012548001","48",NA,"1",NA,1017,758,259,242,157,75,5,1,0,4,17,1271,979,292,271,178,82,5,1,0,5,21,"-095.0168372","+29.7319720"
"606","482012548002","48",NA,"2",NA,521,242,279,264,234,27,0,2,0,1,15,683,344,339,320,270,45,0,2,0,3,19,"-095.0170173","+29.7559128"
"607","482012548003","48",NA,"3",NA,553,266,287,283,51,213,5,2,0,12,4,751,389,362,350,75,253,5,2,0,15,12,"-094.9905227","+29.7345122"
"608","482013101011","48",NA,"1",NA,1663,394,1269,1225,820,276,2,119,0,8,44,1799,459,1340,1284,849,300,2,123,2,8,56,"-095.3500621","+29.7513394"
"609","482013101012","48",NA,"2",NA,1618,763,855,808,466,233,10,89,0,10,47,1856,934,922,860,501,249,10,89,1,10,62,"-095.3392393","+29.7524208"
"610","482013101021","48",NA,"1",NA,733,165,568,547,206,294,3,33,0,11,21,1096,231,865,836,217,564,3,40,0,12,29,"-095.3479482","+29.7629739"
"611","482013101022","48",NA,"2",NA,1169,443,726,703,307,347,2,40,0,7,23,1359,542,817,788,325,403,3,50,0,7,29,"-095.3423041","+29.7584388"
"612","482013102001","48",NA,"1",NA,991,246,745,706,298,284,6,109,0,9,39,1109,271,838,789,318,340,6,114,0,11,49,"-095.3511725","+29.7410241"
"613","482013102002","48",NA,"2",NA,1122,207,915,855,585,146,2,120,0,2,60,1252,238,1014,944,630,172,3,137,0,2,70,"-095.3510808","+29.7459874"
"614","482013103001","48",NA,"1",NA,665,374,291,266,224,23,2,17,0,0,25,781,459,322,291,242,28,3,18,0,0,31,"-095.3305046","+29.7406393"
"615","482013103002","48",NA,"2",NA,533,315,218,209,150,43,0,13,1,2,9,631,397,234,218,157,44,1,13,1,2,16,"-095.3311596","+29.7371952"
"616","482013103003","48",NA,"3",NA,1210,548,662,629,262,318,9,38,0,2,33,1431,712,719,683,281,346,9,40,0,7,36,"-095.3413348","+29.7372483"
"617","482013103004","48",NA,"4",NA,853,452,401,377,288,41,2,39,0,7,24,993,555,438,412,315,48,2,40,0,7,26,"-095.3359979","+29.7359835"
"618","482013103005","48",NA,"5",NA,512,367,145,130,101,12,2,15,0,0,15,604,438,166,147,111,15,2,19,0,0,19,"-095.3360465","+29.7414687"
"619","482013103006","48",NA,"6",NA,469,307,162,158,90,47,0,18,0,3,4,586,393,193,184,101,52,0,28,0,3,9,"-095.3394620","+29.7425558"
"620","482013104001","48",NA,"1",NA,1109,970,139,129,102,16,0,11,0,0,10,1405,1237,168,155,127,16,1,11,0,0,13,"-095.3271555","+29.7549269"
"621","482013104002","48",NA,"2",NA,582,427,155,148,85,45,0,15,0,3,7,701,532,169,159,95,45,1,15,0,3,10,"-095.3340450","+29.7497113"
"622","482013104003","48",NA,"3",NA,999,822,177,164,110,36,0,12,0,6,13,1210,1011,199,179,122,36,3,12,0,6,20,"-095.3309288","+29.7459287"
"623","482013105001","48",NA,"1",NA,622,476,146,140,83,40,0,14,1,2,6,781,629,152,145,86,42,0,14,1,2,7,"-095.3101755","+29.7528532"
"624","482013105002","48",NA,"2",NA,1098,913,185,177,122,32,3,18,0,2,8,1386,1176,210,197,139,35,3,18,0,2,13,"-095.3249275","+29.7457054"
"625","482013105003","48",NA,"3",NA,732,599,133,128,68,52,2,5,0,1,5,875,736,139,133,73,52,2,5,0,1,6,"-095.3195041","+29.7427848"
"626","482013105004","48",NA,"4",NA,543,465,78,68,37,27,0,3,0,1,10,713,624,89,76,38,32,2,3,0,1,13,"-095.3178240","+29.7402990"
"627","482013106001","48",NA,"1",NA,712,513,199,195,140,38,1,15,1,0,4,863,638,225,219,161,40,1,15,2,0,6,"-095.3215125","+29.7371230"
"628","482013106002","48",NA,"2",NA,1313,1050,263,248,188,42,3,10,1,4,15,1630,1334,296,277,201,55,3,12,2,4,19,"-095.3226763","+29.7319324"
"629","482013106003","48",NA,"3",NA,483,400,83,77,46,17,2,6,0,6,6,641,545,96,84,51,19,2,6,0,6,12,"-095.3271895","+29.7336864"
"630","482013106004","48",NA,"4",NA,672,535,137,135,114,17,0,4,0,0,2,858,706,152,149,125,19,0,5,0,0,3,"-095.3271927","+29.7265448"
"631","482013106005","48",NA,"5",NA,802,565,237,219,147,22,3,43,2,2,18,969,706,263,243,164,24,3,48,2,2,20,"-095.3302213","+29.7287200"
"632","482013107001","48",NA,"1",NA,1338,1127,211,196,118,45,0,33,0,0,15,1686,1422,264,241,145,51,1,44,0,0,23,"-095.3213359","+29.7232926"
"633","482013107002","48",NA,"2",NA,1501,988,513,491,420,17,11,34,0,9,22,2013,1411,602,569,480,21,16,43,0,9,33,"-095.3116879","+29.7192561"
"634","482013108001","48",NA,"1",NA,871,809,62,56,31,22,0,2,0,1,6,1227,1142,85,76,41,24,0,2,0,9,9,"-095.3101318","+29.7312519"
"635","482013108002","48",NA,"2",NA,1138,830,308,294,187,69,2,36,0,0,14,1436,1091,345,331,209,79,2,36,0,5,14,"-095.3148580","+29.7283220"
"636","482013109001","48",NA,"1",NA,737,636,101,92,50,38,0,3,0,1,9,978,859,119,108,58,44,0,4,0,2,11,"-095.2942568","+29.7354663"
"637","482013109002","48",NA,"2",NA,1033,954,79,61,42,9,1,8,0,1,18,1357,1250,107,89,52,18,2,12,0,5,18,"-095.2971193","+29.7310229"
"638","482013109003","48",NA,"3",NA,733,619,114,113,65,36,10,2,0,0,1,921,791,130,126,72,40,11,2,0,1,4,"-095.2999752","+29.7360053"
"639","482013109004","48",NA,"4",NA,579,523,56,55,23,6,2,23,0,1,1,822,760,62,60,26,6,2,25,0,1,2,"-095.3080677","+29.7372531"
"640","482013109005","48",NA,"5",NA,964,900,64,60,43,13,2,1,0,1,4,1256,1180,76,69,49,15,3,1,0,1,7,"-095.3061211","+29.7399582"
"641","482013110011","48",NA,"1",NA,964,930,34,34,28,2,3,1,0,0,0,1242,1197,45,40,29,4,3,4,0,0,5,"-095.3023536","+29.7490769"
"642","482013110012","48",NA,"2",NA,1341,1243,98,98,54,31,3,4,0,6,0,1798,1686,112,107,56,34,3,8,0,6,5,"-095.3042305","+29.7427655"
"643","482013110021","48",NA,"1",NA,738,693,45,45,25,10,6,0,1,3,0,992,934,58,58,34,14,6,0,1,3,0,"-095.2914565","+29.7436313"
"644","482013110022","48",NA,"2",NA,664,610,54,53,31,14,3,4,0,1,1,869,801,68,67,41,16,3,6,0,1,1,"-095.2984315","+29.7485868"
"645","482013110023","48",NA,"3",NA,1051,980,71,71,61,6,0,1,1,2,0,1438,1350,88,87,71,11,0,1,1,3,1,"-095.2964273","+29.7425961"
"646","482013111001","48",NA,"1",NA,778,736,42,38,21,13,0,3,0,1,4,1058,1002,56,52,26,18,1,4,0,3,4,"-095.2843045","+29.7381574"
"647","482013111002","48",NA,"2",NA,758,696,62,61,53,7,0,1,0,0,1,971,888,83,82,73,8,0,1,0,0,1,"-095.2871764","+29.7239766"
"648","482013111003","48",NA,"3",NA,1084,1013,71,65,57,3,0,5,0,0,6,1451,1374,77,71,59,6,0,5,0,1,6,"-095.2841941","+29.7273284"
"649","482013111004","48",NA,"4",NA,1337,1261,76,69,41,23,0,3,0,2,7,1758,1662,96,87,47,31,0,5,0,4,9,"-095.2856287","+29.7327615"
"650","482013112001","48",NA,"1",NA,1141,1062,79,78,65,10,0,3,0,0,1,1555,1465,90,88,70,15,0,3,0,0,2,"-095.2926546","+29.7207487"
"651","482013112002","48",NA,"2",NA,1388,1217,171,160,108,33,3,13,0,3,11,1812,1610,202,185,121,42,4,13,0,5,17,"-095.2961058","+29.7199148"
"652","482013112003","48",NA,"3",NA,976,705,271,265,146,115,0,2,0,2,6,1221,924,297,284,159,118,1,2,0,4,13,"-095.3042632","+29.7177998"
"653","482013113001","48",NA,"1",NA,1198,1101,97,87,58,21,0,3,0,5,10,1608,1494,114,97,66,21,0,3,2,5,17,"-095.2912165","+29.7137904"
"654","482013113002","48",NA,"2",NA,1129,1053,76,73,63,1,1,7,0,1,3,1516,1418,98,90,74,1,1,9,0,5,8,"-095.2929133","+29.7072301"
"655","482013113003","48",NA,"3",NA,1331,1262,69,66,53,7,0,4,1,1,3,1788,1701,87,80,63,7,1,5,1,3,7,"-095.2987745","+29.7075600"
"656","482013114001","48",NA,"1",NA,1186,965,221,209,63,144,2,0,0,0,12,1546,1299,247,230,69,157,2,0,0,2,17,"-095.2752207","+29.7190269"
"657","482013115011","48",NA,"1",NA,862,756,106,99,33,55,0,9,0,2,7,1242,1121,121,112,35,65,1,9,0,2,9,"-095.2896714","+29.7040730"
"658","482013115012","48",NA,"2",NA,1354,1266,88,83,48,27,0,6,0,2,5,1724,1621,103,96,53,28,4,9,0,2,7,"-095.2836600","+29.7065373"
"659","482013115021","48",NA,"1",NA,689,552,137,136,16,11,0,109,0,0,1,949,792,157,155,22,13,0,120,0,0,2,"-095.2782135","+29.7048343"
"660","482013115022","48",NA,"2",NA,1520,1441,79,74,49,15,0,4,0,6,5,2036,1940,96,87,54,20,0,6,0,7,9,"-095.2842443","+29.7114442"
"661","482013115023","48",NA,"3",NA,515,466,49,48,29,15,0,4,0,0,1,738,670,68,62,33,23,0,4,0,2,6,"-095.2758155","+29.7106342"
"662","482013116001","48",NA,"1",NA,750,672,78,69,4,56,0,6,0,3,9,1102,1011,91,82,13,60,0,6,0,3,9,"-095.2870281","+29.7034226"
"663","482013116002","48",NA,"2",NA,870,747,123,114,27,67,2,13,0,5,9,1247,1105,142,132,29,81,2,13,0,7,10,"-095.2885055","+29.7013406"
"664","482013116003","48",NA,"3",NA,890,774,116,110,6,84,0,19,0,1,6,1279,1141,138,132,8,95,0,23,0,6,6,"-095.2857971","+29.7007796"
"665","482013117011","48",NA,"1",NA,1586,1439,147,144,90,48,0,0,0,6,3,2154,1963,191,173,103,58,0,3,0,9,18,"-095.3149072","+29.6992833"
"666","482013117012","48",NA,"2",NA,935,772,163,162,36,120,0,6,0,0,1,1352,1099,253,248,42,197,0,8,0,1,5,"-095.3043667","+29.6989092"
"667","482013117021","48",NA,"1",NA,1293,875,418,399,76,305,0,16,0,2,19,1890,1347,543,517,83,413,1,16,0,4,26,"-095.2990496","+29.7010603"
"668","482013118001","48",NA,"1",NA,1164,928,236,233,75,120,6,22,0,10,3,1504,1239,265,261,85,138,6,22,0,10,4,"-095.3160603","+29.7045188"
"669","482013118002","48",NA,"2",NA,1234,1111,123,115,75,23,0,15,0,2,8,1628,1483,145,133,80,33,3,15,0,2,12,"-095.3238875","+29.7049003"
"670","482013118003","48",NA,"3",NA,842,777,65,60,24,23,0,10,0,3,5,1193,1112,81,73,34,25,1,10,0,3,8,"-095.3102871","+29.7087080"
"671","482013119001","48",NA,"1",NA,730,600,130,124,74,27,5,17,0,1,6,927,781,146,133,82,27,5,17,0,2,13,"-095.3173190","+29.7122706"
"672","482013119002","48",NA,"2",NA,916,783,133,124,70,49,0,5,0,0,9,1218,1051,167,153,73,65,4,10,0,1,14,"-095.3290191","+29.7193776"
"673","482013120001","48",NA,"1",NA,1106,227,879,861,354,365,0,141,0,1,18,1196,237,959,930,385,399,0,145,0,1,29,"-095.3375747","+29.7169640"
"674","482013120002","48",NA,"2",NA,2307,294,2013,1966,605,816,1,540,0,4,47,2397,317,2080,2025,612,868,1,540,0,4,55,"-095.3524662","+29.7132235"
"675","482013120003","48",NA,"3",NA,2155,470,1685,1652,653,240,3,754,0,2,33,2166,470,1696,1663,654,246,3,758,0,2,33,"-095.3479255","+29.7174850"
"676","482013122001","48",NA,"1",NA,562,82,480,464,11,429,1,21,0,2,16,727,116,611,592,15,546,4,21,1,5,19,"-095.3478700","+29.7327913"
"677","482013122002","48",NA,"2",NA,752,105,647,633,117,489,2,24,0,1,14,866,136,730,714,118,566,3,24,1,2,16,"-095.3478342","+29.7293115"
"678","482013122003","48",NA,"3",NA,596,109,487,473,25,432,6,9,0,1,14,758,156,602,586,27,542,7,9,0,1,16,"-095.3537453","+29.7331435"
"679","482013123001","48",NA,"1",NA,1106,185,921,889,300,454,2,127,0,6,32,1320,239,1081,1035,325,556,6,140,0,8,46,"-095.3626070","+29.7398734"
"680","482013123002","48",NA,"2",NA,856,149,707,684,49,617,1,17,0,0,23,1090,213,877,846,56,768,1,19,0,2,31,"-095.3575075","+29.7359680"
"681","482013124001","48",NA,"1",NA,616,124,492,475,85,373,1,13,0,3,17,777,158,619,594,99,478,1,13,0,3,25,"-095.3670241","+29.7329470"
"682","482013124002","48",NA,"2",NA,424,48,376,365,31,325,1,8,0,0,11,526,67,459,445,37,399,1,8,0,0,14,"-095.3609873","+29.7292320"
"683","482013124003","48",NA,"3",NA,515,43,472,460,18,427,0,13,0,2,12,678,61,617,596,23,558,0,13,0,2,21,"-095.3540027","+29.7268929"
"684","482013125011","48",NA,"1",NA,1371,230,1141,1089,633,204,3,233,0,16,52,1506,258,1248,1178,668,226,3,256,0,25,70,"-095.3680437","+29.7427721"
"685","482013125012","48",NA,"2",NA,860,167,693,660,343,184,0,129,0,4,33,978,195,783,743,365,235,0,139,0,4,40,"-095.3723784","+29.7435216"
"686","482013125021","48",NA,"1",NA,1286,230,1056,1029,537,438,7,43,1,3,27,1384,262,1122,1085,560,460,7,51,1,6,37,"-095.3789095","+29.7344792"
"687","482013125022","48",NA,"2",NA,911,159,752,722,326,313,7,70,0,6,30,1000,184,816,779,354,333,7,76,0,9,37,"-095.3745739","+29.7374235"
"688","482013126011","48",NA,"1",NA,1153,154,999,962,707,68,0,182,0,5,37,1243,170,1073,1029,745,71,3,203,0,7,44,"-095.3835955","+29.7198075"
"689","482013126012","48",NA,"2",NA,859,129,730,683,362,175,0,136,2,8,47,961,143,818,758,391,199,6,149,2,11,60,"-095.3813741","+29.7196935"
"690","482013126013","48",NA,"3",NA,555,53,502,496,389,33,0,74,0,0,6,593,63,530,514,394,41,1,78,0,0,16,"-095.3872372","+29.7231377"
"691","482013126021","48",NA,"1",NA,841,160,681,644,395,102,0,140,0,7,37,974,209,765,709,439,109,0,150,0,11,56,"-095.3819699","+29.7259794"
"692","482013126022","48",NA,"2",NA,1367,178,1189,1147,713,269,1,156,1,7,42,1479,196,1283,1234,767,283,2,173,1,8,49,"-095.3847563","+29.7255183"
"693","482013126031","48",NA,"1",NA,1564,296,1268,1220,599,332,2,286,0,1,48,1697,332,1365,1302,628,366,2,301,0,5,63,"-095.3786298","+29.7212530"
"694","482013126032","48",NA,"2",NA,1193,252,941,878,439,267,2,164,0,6,63,1385,327,1058,980,477,307,3,183,0,10,78,"-095.3786412","+29.7304707"
"695","482013127001","48",NA,"1",NA,696,94,602,592,100,471,7,13,0,1,10,817,125,692,671,105,543,7,13,0,3,21,"-095.3707071","+29.7283643"
"696","482013127002","48",NA,"2",NA,869,114,755,733,157,535,1,34,0,6,22,1042,133,909,878,178,658,1,34,0,7,31,"-095.3659665","+29.7253139"
"697","482013128001","48",NA,"1",NA,569,47,522,509,13,489,0,6,1,0,13,942,65,877,859,13,832,0,13,1,0,18,"-095.3599982","+29.7252912"
"698","482013128002","48",NA,"2",NA,4195,636,3559,3474,1187,1040,1,1235,1,10,85,4534,677,3857,3754,1191,1314,2,1235,1,11,103,"-095.3576431","+29.7214760"
"699","482013129011","48",NA,"1",NA,510,28,482,482,27,447,0,8,0,0,0,693,36,657,657,27,619,0,11,0,0,0,"-095.3592855","+29.7117459"
"700","482013129012","48",NA,"2",NA,707,67,640,628,49,534,1,44,0,0,12,812,82,730,712,49,609,1,52,0,1,18,"-095.3570693","+29.7152142"
"701","482013129021","48",NA,"1",NA,589,44,545,530,60,445,2,18,1,4,15,676,65,611,593,66,500,4,18,1,4,18,"-095.3611434","+29.7162117"
"702","482013129022","48",NA,"2",NA,951,54,897,867,125,727,0,12,3,0,30,1125,75,1050,1017,139,857,1,12,3,5,33,"-095.3661642","+29.7157415"
"703","482013130001","48",NA,"1",NA,666,59,607,585,131,438,1,11,2,2,22,786,74,712,677,140,518,1,14,2,2,35,"-095.3746795","+29.7219976"
"704","482013130002","48",NA,"2",NA,731,95,636,620,136,455,2,24,0,3,16,867,138,729,706,144,523,2,34,0,3,23,"-095.3735071","+29.7156476"
"705","482013130003","48",NA,"3",NA,701,74,627,602,102,463,2,29,1,5,25,809,96,713,681,109,535,2,29,1,5,32,"-095.3696050","+29.7206271"
"706","482013131011","48",NA,"1",NA,1072,198,874,842,499,163,2,177,0,1,32,1146,223,923,883,512,174,2,194,0,1,40,"-095.3801828","+29.7111371"
"707","482013131012","48",NA,"2",NA,1043,156,887,850,531,148,1,169,0,1,37,1151,194,957,909,557,163,1,187,0,1,48,"-095.3796059","+29.7063194"
"708","482013131021","48",NA,"1",NA,1788,204,1584,1522,899,159,2,455,0,7,62,2011,226,1785,1706,968,181,3,543,4,7,79,"-095.3916512","+29.7137231"
"709","482013132011","48",NA,"1",NA,1392,74,1318,1264,132,1061,0,50,1,20,54,1610,97,1513,1456,145,1230,0,57,1,23,57,"-095.3504938","+29.7064172"
"710","482013132021","48",NA,"1",NA,558,68,490,477,52,411,0,12,0,2,13,744,113,631,610,65,529,0,14,0,2,21,"-095.3647818","+29.7042403"
"711","482013132022","48",NA,"2",NA,1021,123,898,872,241,579,0,46,5,1,26,1195,148,1047,1005,247,706,0,46,5,1,42,"-095.3753599","+29.7107269"
"712","482013132023","48",NA,"3",NA,726,38,688,672,100,545,0,26,0,1,16,851,56,795,758,112,619,0,26,0,1,37,"-095.3638545","+29.7087806"
"713","482013133001","48",NA,"1",NA,1459,172,1287,1256,100,1087,0,62,0,7,31,1731,217,1514,1476,105,1302,0,62,0,7,38,"-095.3319122","+29.7019120"
"714","482013133002","48",NA,"2",NA,1185,182,1003,973,85,882,2,2,0,2,30,1425,241,1184,1142,96,1038,2,2,0,4,42,"-095.3376404","+29.7067217"
"715","482013134001","48",NA,"1",NA,952,203,749,723,50,652,1,18,0,2,26,1150,285,865,835,56,755,1,21,0,2,30,"-095.3449513","+29.6974970"
"716","482013134002","48",NA,"2",NA,802,135,667,658,85,547,1,23,0,2,9,966,188,778,769,92,647,1,27,0,2,9,"-095.3331063","+29.6909393"
"717","482013134003","48",NA,"3",NA,1086,218,868,855,34,803,10,4,0,4,13,1487,340,1147,1129,44,1063,14,4,0,4,18,"-095.3365194","+29.6943743"
"718","482013135001","48",NA,"1",NA,597,117,480,476,13,458,0,5,0,0,4,803,209,594,585,16,564,0,5,0,0,9,"-095.3445570","+29.6925547"
"719","482013135002","48",NA,"2",NA,855,137,718,699,30,654,4,4,0,7,19,1113,206,907,883,30,838,4,4,0,7,24,"-095.3483815","+29.6906182"
"720","482013135003","48",NA,"3",NA,525,122,403,391,24,366,0,1,0,0,12,733,207,526,512,25,486,0,1,0,0,14,"-095.3493142","+29.6857028"
"721","482013136001","48",NA,"1",NA,1067,348,719,693,47,633,1,12,0,0,26,1350,487,863,835,51,768,1,12,0,3,28,"-095.3557052","+29.6983570"
"722","482013136002","48",NA,"2",NA,1323,487,836,817,44,764,0,6,0,3,19,1758,723,1035,1009,49,943,5,8,0,4,26,"-095.3561090","+29.6907424"
"723","482013136003","48",NA,"3",NA,554,51,503,489,19,466,0,3,0,1,14,734,108,626,605,24,574,3,3,0,1,21,"-095.3618290","+29.6887257"
"724","482013136004","48",NA,"4",NA,612,65,547,526,3,521,2,0,0,0,21,1029,96,933,908,4,896,8,0,0,0,25,"-095.3611574","+29.6829729"
"725","482013137001","48",NA,"1",NA,720,42,678,662,21,629,4,5,0,3,16,922,60,862,841,22,805,4,7,0,3,21,"-095.3654570","+29.6937999"
"726","482013137002","48",NA,"2",NA,1060,133,927,898,35,854,2,3,0,4,29,1334,190,1144,1107,42,1051,2,6,1,5,37,"-095.3670472","+29.6992623"
"727","482013138011","48",NA,"1",NA,757,61,696,688,26,659,0,2,0,1,8,1240,102,1138,1122,37,1082,0,2,0,1,16,"-095.3694632","+29.6903245"
"728","482013138012","48",NA,"2",NA,620,65,555,541,7,525,4,5,0,0,14,795,112,683,660,11,635,4,10,0,0,23,"-095.3696525","+29.6860990"
"729","482013138021","48",NA,"1",NA,802,54,748,744,4,738,0,2,0,0,4,1306,101,1205,1195,4,1187,0,4,0,0,10,"-095.3751198","+29.6947158"
"730","482013138022","48",NA,"2",NA,500,91,409,394,21,363,0,10,0,0,15,621,138,483,464,21,433,0,10,0,0,19,"-095.3767537","+29.6863209"
"731","482013138023","48",NA,"3",NA,625,121,504,489,27,446,0,10,0,6,15,870,191,679,650,29,596,0,11,3,11,29,"-095.3737735","+29.6829394"
"732","482013139011","48",NA,"1",NA,1332,207,1125,1057,371,381,0,297,0,8,68,1454,231,1223,1143,392,426,0,317,0,8,80,"-095.3835237","+29.6994333"
"733","482013139012","48",NA,"2",NA,691,109,582,542,151,316,0,70,1,4,40,757,118,639,588,160,352,0,71,1,4,51,"-095.3830000","+29.6920434"
"734","482013139021","48",NA,"1",NA,664,104,560,518,157,217,0,132,2,10,42,731,112,619,562,172,244,0,132,2,12,57,"-095.3848682","+29.6823899"
"735","482013139022","48",NA,"2",NA,817,102,715,693,203,327,2,157,1,3,22,916,118,798,771,224,360,4,179,1,3,27,"-095.3894292","+29.6830676"
"736","482013139023","48",NA,"3",NA,825,82,743,719,188,272,0,251,0,8,24,945,101,844,808,205,318,1,272,0,12,36,"-095.3815155","+29.6853720"
"737","482013140011","48",NA,"1",NA,1529,181,1348,1304,423,186,2,690,0,3,44,1617,194,1423,1376,443,193,2,735,0,3,47,"-095.3910949","+29.6922259"
"738","482013140012","48",NA,"2",NA,1395,201,1194,1131,553,267,0,303,0,8,63,1487,216,1271,1201,579,285,0,323,0,14,70,"-095.3943104","+29.6990602"
"739","482013140031","48",NA,"1",NA,725,49,676,668,102,36,0,528,0,2,8,882,56,826,814,123,46,4,639,0,2,12,"-095.3948468","+29.6916128"
"740","482013140032","48",NA,"2",NA,659,46,613,601,194,50,0,353,0,4,12,713,58,655,637,212,51,0,370,0,4,18,"-095.3971411","+29.6938408"
"741","482013140033","48",NA,"3",NA,935,129,806,799,213,84,0,502,0,0,7,996,132,864,857,223,96,0,538,0,0,7,"-095.4015847","+29.6887184"
"742","482013140041","48",NA,"1",NA,636,133,503,477,100,225,0,145,0,7,26,718,137,581,549,114,273,0,154,0,8,32,"-095.3982505","+29.6864408"
"743","482013140042","48",NA,"2",NA,875,135,740,727,210,285,0,226,0,6,13,950,145,805,791,229,319,0,237,0,6,14,"-095.3969950","+29.6879608"
"744","482013140051","48",NA,"1",NA,1309,132,1177,1148,522,211,5,409,0,1,29,1456,164,1292,1257,537,252,5,455,0,8,35,"-095.4000375","+29.6815410"
"745","482013140052","48",NA,"2",NA,918,130,788,771,123,307,0,322,0,19,17,1012,143,869,850,131,363,0,336,0,20,19,"-095.3977592","+29.6838086"
"746","482013143011","48",NA,"1",NA,932,103,829,808,40,721,4,38,0,5,21,1185,144,1041,1000,42,908,5,40,0,5,41,"-095.4176784","+29.6801435"
"747","482013143012","48",NA,"2",NA,960,97,863,841,72,734,0,33,0,2,22,1178,115,1063,1031,79,907,0,39,0,6,32,"-095.4135623","+29.6800543"
"748","482013143021","48",NA,"1",NA,1085,107,978,966,78,806,2,70,0,10,12,1338,121,1217,1202,89,1024,4,72,0,13,15,"-095.4226845","+29.6797770"
"749","482013143022","48",NA,"2",NA,907,85,822,797,40,675,0,80,0,2,25,1102,99,1003,974,47,837,0,88,0,2,29,"-095.4165261","+29.6866213"
"750","482013144011","48",NA,"1",NA,1373,174,1199,1160,503,100,0,552,0,5,39,1545,205,1340,1296,538,108,0,645,0,5,44,"-095.4031567","+29.6965953"
"751","482013144021","48",NA,"1",NA,834,97,737,720,277,119,1,323,0,0,17,987,123,864,843,309,140,1,391,0,2,21,"-095.4107905","+29.6938710"
"752","482013144022","48",NA,"2",NA,643,67,576,546,153,53,1,339,0,0,30,730,83,647,614,160,56,1,396,0,1,33,"-095.4087255","+29.6870467"
"753","482013201001","48",NA,"1",NA,1187,1015,172,167,78,68,1,14,0,6,5,1562,1351,211,198,89,81,1,18,0,9,13,"-095.2818502","+29.6974192"
"754","482013201002","48",NA,"2",NA,639,545,94,91,53,23,0,14,0,1,3,846,726,120,108,59,31,0,17,0,1,12,"-095.2805949","+29.6914704"
"755","482013202011","48",NA,"1",NA,802,676,126,120,43,19,0,55,0,3,6,1182,1029,153,144,45,26,0,69,0,4,9,"-095.2746572","+29.7006217"
"756","482013202012","48",NA,"2",NA,881,763,118,115,62,31,7,12,0,3,3,1279,1145,134,129,66,35,8,15,0,5,5,"-095.2652033","+29.6990613"
"757","482013202021","48",NA,"1",NA,599,429,170,164,41,3,0,114,0,6,6,800,602,198,190,43,3,0,137,0,7,8,"-095.2744607","+29.6917124"
"758","482013202022","48",NA,"2",NA,1163,623,540,534,106,40,1,385,0,2,6,1560,907,653,647,109,50,1,485,0,2,6,"-095.2663708","+29.6890533"
"759","482013202023","48",NA,"3",NA,923,735,188,183,83,37,0,60,0,3,5,1288,1069,219,212,92,51,0,66,0,3,7,"-095.2716081","+29.6947347"
"760","482013205001","48",NA,"1",NA,1689,1493,196,173,123,31,12,7,0,0,23,2261,2047,214,187,128,38,14,7,0,0,27,"-095.2522701","+29.6925996"
"761","482013205002","48",NA,"2",NA,1502,1368,134,124,112,11,0,1,0,0,10,2039,1884,155,144,120,23,0,1,0,0,11,"-095.2433121","+29.6961467"
"762","482013206011","48",NA,"1",NA,1139,1011,128,123,83,17,5,17,0,1,5,1567,1393,174,165,108,18,9,26,0,4,9,"-095.2610048","+29.6836402"
"763","482013206012","48",NA,"2",NA,633,517,116,105,49,35,4,15,0,2,11,907,768,139,124,54,46,4,15,0,5,15,"-095.2674469","+29.6812147"
"764","482013206021","48",NA,"1",NA,1281,950,331,324,91,208,0,16,0,9,7,1678,1330,348,340,95,219,0,17,0,9,8,"-095.2621989","+29.6724969"
"765","482013206022","48",NA,"2",NA,927,878,49,45,35,5,3,0,0,2,4,1295,1231,64,59,41,11,3,0,0,4,5,"-095.2557155","+29.6770482"
"766","482013206023","48",NA,"3",NA,1091,1027,64,63,38,6,2,15,0,2,1,1487,1414,73,72,45,7,2,16,0,2,1,"-095.2603968","+29.6793289"
"767","482013207001","48",NA,"1",NA,1157,725,432,423,83,110,7,216,0,7,9,1619,1068,551,542,117,151,7,256,0,11,9,"-095.2527371","+29.6678299"
"768","482013207002","48",NA,"2",NA,1244,753,491,487,151,310,0,25,0,1,4,1762,1104,658,654,157,465,0,30,0,2,4,"-095.2497085","+29.6822878"
"769","482013207003","48",NA,"3",NA,894,687,207,196,136,33,0,25,0,2,11,1169,930,239,227,137,49,4,34,0,3,12,"-095.2421204","+29.6752108"
"770","482013208001","48",NA,"1",NA,822,791,31,31,27,1,0,2,0,1,0,1163,1129,34,34,30,1,0,2,0,1,0,"-095.2462019","+29.6613042"
"771","482013208002","48",NA,"2",NA,1116,1061,55,52,45,3,0,3,0,1,3,1584,1513,71,66,55,6,0,4,0,1,5,"-095.2421529","+29.6657598"
"772","482013208003","48",NA,"3",NA,1663,1421,242,237,190,13,0,29,0,5,5,2276,1989,287,282,214,19,0,43,0,6,5,"-095.2376244","+29.6560172"
"773","482013209011","48",NA,"1",NA,1312,1163,149,139,91,22,1,19,0,6,10,1849,1678,171,159,100,27,1,22,0,9,12,"-095.2444639","+29.6495235"
"774","482013209012","48",NA,"2",NA,1307,602,705,686,102,552,3,27,0,2,19,1909,909,1000,975,123,808,8,31,0,5,25,"-095.2423232","+29.6441972"
"775","482013209021","48",NA,"1",NA,1411,1197,214,212,143,24,0,34,0,11,2,1935,1686,249,242,167,30,0,34,0,11,7,"-095.2348807","+29.6487017"
"776","482013209022","48",NA,"2",NA,1277,1110,167,160,119,23,2,13,0,3,7,1787,1578,209,194,129,41,2,19,0,3,15,"-095.2285280","+29.6489099"
"777","482013210011","48",NA,"1",NA,512,383,129,124,31,92,0,1,0,0,5,803,623,180,174,39,129,0,5,0,1,6,"-095.2330606","+29.6363873"
"778","482013210012","48",NA,"2",NA,522,336,186,185,33,152,0,0,0,0,1,732,484,248,247,42,205,0,0,0,0,1,"-095.2364386","+29.6361244"
"779","482013210013","48",NA,"3",NA,909,755,154,138,86,20,0,27,0,5,16,1241,1054,187,165,94,35,0,27,0,9,22,"-095.2272195","+29.6325485"
"780","482013210021","48",NA,"1",NA,991,836,155,150,131,14,0,5,0,0,5,1387,1180,207,194,154,24,0,14,0,2,13,"-095.2244284","+29.6443187"
"781","482013210022","48",NA,"2",NA,1050,796,254,243,125,81,0,36,0,1,11,1380,1085,295,281,133,105,0,39,0,4,14,"-095.2211322","+29.6377960"
"782","482013210023","48",NA,"3",NA,1987,1674,313,300,251,21,4,24,0,0,13,2683,2336,347,323,270,24,4,24,0,1,24,"-095.2345098","+29.6404840"
"783","482013211011","48",NA,"1",NA,1667,879,788,758,196,249,1,307,0,5,30,2272,1251,1021,983,231,359,1,384,1,7,38,"-095.2032333","+29.6155515"
"784","482013211012","48",NA,"2",NA,1382,621,761,744,247,447,1,47,0,2,17,1736,832,904,880,276,535,1,60,0,8,24,"-095.2093390","+29.6146750"
"785","482013211021","48",NA,"1",NA,957,704,253,243,208,24,0,11,0,0,10,1282,989,293,277,236,29,1,11,0,0,16,"-095.2080131","+29.6296833"
"786","482013211022","48",NA,"2",NA,815,585,230,208,152,18,4,32,1,1,22,1120,838,282,258,171,30,4,51,1,1,24,"-095.2074917","+29.6237665"
"787","482013211023","48",NA,"3",NA,1250,960,290,290,77,80,1,128,4,0,0,1696,1330,366,360,97,106,4,149,4,0,6,"-095.2180614","+29.6293152"
"788","482013212001","48",NA,"1",NA,1507,1214,293,276,162,89,0,21,0,4,17,2327,1923,404,384,199,150,1,28,0,6,20,"-095.1994109","+29.6330089"
"789","482013212002","48",NA,"2",NA,1350,1142,208,184,104,51,1,21,2,5,24,2185,1892,293,265,136,78,1,40,2,8,28,"-095.2040014","+29.6471152"
"790","482013213011","48",NA,"1",NA,1111,821,290,283,64,192,0,24,0,3,7,1614,1230,384,373,70,270,0,26,0,7,11,"-095.2200655","+29.6508912"
"791","482013213012","48",NA,"2",NA,1154,891,263,250,90,138,6,8,0,8,13,1750,1359,391,370,116,224,6,10,0,14,21,"-095.2175768","+29.6472280"
"792","482013213021","48",NA,"1",NA,1330,1014,316,310,246,47,6,6,0,5,6,1892,1510,382,366,271,74,6,9,0,6,16,"-095.2117152","+29.6447146"
"793","482013214011","48",NA,"1",NA,875,802,73,67,56,8,0,2,0,1,6,1219,1124,95,80,60,16,1,2,0,1,15,"-095.2334616","+29.6665589"
"794","482013214012","48",NA,"2",NA,1179,1039,140,128,110,8,2,4,0,4,12,1608,1450,158,145,117,13,7,4,0,4,13,"-095.2189327","+29.6641384"
"795","482013214013","48",NA,"3",NA,1078,934,144,136,113,12,1,6,0,4,8,1509,1347,162,152,123,16,2,6,0,5,10,"-095.2261441","+29.6662272"
"796","482013214021","48",NA,"1",NA,757,628,129,125,93,30,1,1,0,0,4,1023,882,141,136,101,30,1,3,0,1,5,"-095.2150911","+29.6584915"
"797","482013214022","48",NA,"2",NA,831,728,103,95,81,2,1,11,0,0,8,1155,1037,118,107,90,4,1,12,0,0,11,"-095.2277732","+29.6581606"
"798","482013214023","48",NA,"3",NA,1310,1121,189,180,152,18,4,6,0,0,9,1899,1661,238,223,175,32,4,6,1,5,15,"-095.2161468","+29.6548723"
"799","482013215001","48",NA,"1",NA,1107,1003,104,96,55,28,0,8,1,4,8,1637,1497,140,128,71,39,2,8,1,7,12,"-095.2128081","+29.6675540"
"800","482013215002","48",NA,"2",NA,725,557,168,168,67,92,0,8,0,1,0,1080,822,258,256,92,154,0,9,0,1,2,"-095.2105758","+29.6615197"
"801","482013216001","48",NA,"1",NA,1098,914,184,182,170,12,0,0,0,0,2,1512,1296,216,210,197,12,0,1,0,0,6,"-095.2181244","+29.6837796"
"802","482013216002","48",NA,"2",NA,677,529,148,145,114,12,4,15,0,0,3,919,755,164,157,121,17,4,15,0,0,7,"-095.2224168","+29.6807451"
"803","482013216003","48",NA,"3",NA,915,700,215,207,155,45,1,6,0,0,8,1283,1027,256,246,179,59,1,7,0,0,10,"-095.2254682","+29.6741915"
"804","482013216004","48",NA,"4",NA,1386,1240,146,140,119,13,1,7,0,0,6,2013,1837,176,169,144,17,1,7,0,0,7,"-095.2120575","+29.6740616"
"805","482013216005","48",NA,"5",NA,757,613,144,138,119,14,5,0,0,0,6,1065,890,175,165,133,26,5,1,0,0,10,"-095.2183571","+29.6729900"
"806","482013217001","48",NA,"1",NA,1115,821,294,288,251,18,0,15,0,4,6,1487,1165,322,315,269,26,0,15,0,5,7,"-095.2394273","+29.6796532"
"807","482013217002","48",NA,"2",NA,1199,1051,148,145,108,12,0,21,1,3,3,1621,1452,169,164,124,12,0,24,1,3,5,"-095.2317335","+29.6782764"
"808","482013218001","48",NA,"1",NA,1423,1295,128,119,100,17,0,2,0,0,9,1908,1773,135,126,106,17,0,3,0,0,9,"-095.2381339","+29.6906894"
"809","482013218002","48",NA,"2",NA,1488,1322,166,156,130,19,3,4,0,0,10,2019,1821,198,188,156,19,3,10,0,0,10,"-095.2402801","+29.6861614"
"810","482013219001","48",NA,"1",NA,784,657,127,122,105,2,0,8,0,7,5,1068,926,142,137,116,2,0,12,0,7,5,"-095.2234385","+29.7047081"
"811","482013219002","48",NA,"2",NA,1074,954,120,120,89,10,4,13,0,4,0,1513,1375,138,136,104,10,4,14,0,4,2,"-095.2259469","+29.6969216"
"812","482013219003","48",NA,"3",NA,1396,1200,196,187,163,17,1,0,0,6,9,1995,1775,220,208,178,22,1,0,0,7,12,"-095.2269079","+29.6872420"
"813","482013219004","48",NA,"4",NA,777,689,88,82,74,3,1,4,0,0,6,1081,975,106,100,91,4,1,4,0,0,6,"-095.2223908","+29.6942158"
"814","482013220001","48",NA,"1",NA,489,397,92,91,43,33,0,5,0,10,1,761,634,127,126,64,47,0,5,0,10,1,"-095.2175148","+29.7015072"
"815","482013220002","48",NA,"2",NA,525,439,86,82,63,13,1,3,0,2,4,729,610,119,114,87,16,4,4,0,3,5,"-095.2181780","+29.6943930"
"816","482013220003","48",NA,"3",NA,1463,1324,139,137,50,62,0,22,0,3,2,2281,2050,231,225,76,118,0,24,1,6,6,"-095.2190126","+29.7071257"
"817","482013221001","48",NA,"1",NA,1148,839,309,293,234,42,2,13,0,2,16,1564,1186,378,353,276,58,2,13,2,2,25,"-095.2051763","+29.6944686"
"818","482013221002","48",NA,"2",NA,562,488,74,68,49,13,1,3,0,2,6,771,673,98,89,65,16,1,3,0,4,9,"-095.2124642","+29.6940539"
"819","482013221003","48",NA,"3",NA,1261,1084,177,165,115,37,2,6,0,5,12,1807,1572,235,218,139,66,2,6,0,5,17,"-095.2124386","+29.6844121"
"820","482013222001","48",NA,"1",NA,1241,1083,158,142,122,9,0,9,0,2,16,1831,1636,195,175,140,17,0,12,0,6,20,"-095.2137873","+29.7048504"
"821","482013226001","48",NA,"1",NA,1220,778,442,424,392,16,2,13,1,0,18,1627,1100,527,506,469,19,2,14,1,1,21,"-095.1597270","+29.7063194"
"822","482013226002","48",NA,"2",NA,1598,1113,485,461,420,37,0,4,0,0,24,2227,1633,594,564,497,54,1,6,0,6,30,"-095.1571719","+29.6960717"
"823","482013226003","48",NA,"3",NA,1061,717,344,333,276,43,0,11,1,2,11,1383,978,405,392,321,50,0,14,1,6,13,"-095.1580232","+29.6890679"
"824","482013227011","48",NA,"1",NA,1182,902,280,259,219,26,1,5,1,7,21,1614,1285,329,305,255,29,6,5,1,9,24,"-095.1656878","+29.6927171"
"825","482013227012","48",NA,"2",NA,872,649,223,205,190,9,3,2,0,1,18,1193,919,274,250,228,16,3,2,0,1,24,"-095.1667616","+29.6971668"
"826","482013227021","48",NA,"1",NA,1874,1511,363,350,332,13,0,4,0,1,13,2634,2175,459,433,407,16,0,6,0,4,26,"-095.1667991","+29.7085427"
"827","482013227022","48",NA,"2",NA,1163,809,354,321,291,17,0,8,0,5,33,1702,1286,416,379,328,25,4,10,0,12,37,"-095.1668265","+29.7018952"
"828","482013228001","48",NA,"1",NA,1140,936,204,197,190,5,2,0,0,0,7,1582,1348,234,225,214,9,2,0,0,0,9,"-095.1791101","+29.7092911"
"829","482013228002","48",NA,"2",NA,895,781,114,112,101,10,0,1,0,0,2,1279,1130,149,146,132,12,0,1,0,1,3,"-095.1793962","+29.7012298"
"830","482013228003","48",NA,"3",NA,1096,859,237,226,210,11,1,2,0,2,11,1527,1249,278,266,245,13,1,2,0,5,12,"-095.1740147","+29.7018250"
"831","482013228004","48",NA,"4",NA,1330,1163,167,162,145,15,0,1,0,1,5,1858,1657,201,195,172,21,0,1,0,1,6,"-095.1896386","+29.7081921"
"832","482013229001","48",NA,"1",NA,1400,1259,141,135,111,18,1,3,0,2,6,2012,1848,164,158,122,30,1,3,0,2,6,"-095.1969741","+29.7063163"
"833","482013229002","48",NA,"2",NA,548,419,129,120,78,37,0,4,1,0,9,778,604,174,165,98,62,0,4,1,0,9,"-095.1842325","+29.6998840"
"834","482013229003","48",NA,"3",NA,922,761,161,155,138,5,1,0,6,5,6,1282,1108,174,168,151,5,1,0,6,5,6,"-095.1934104","+29.7006548"
"835","482013230001","48",NA,"1",NA,704,501,203,193,131,56,3,0,0,3,10,1004,751,253,243,152,85,3,0,0,3,10,"-095.1896261","+29.6944576"
"836","482013230002","48",NA,"2",NA,1336,1059,277,264,210,45,5,2,0,2,13,1852,1533,319,303,227,66,5,2,0,3,16,"-095.1858853","+29.6934300"
"837","482013230003","48",NA,"3",NA,1041,943,98,93,68,9,0,0,0,16,5,1601,1464,137,132,99,14,0,0,0,19,5,"-095.1899114","+29.6971306"
"838","482013230004","48",NA,"4",NA,906,777,129,124,78,30,2,2,0,12,5,1364,1202,162,156,93,46,2,2,0,13,6,"-095.1944913","+29.6952300"
"839","482013231001","48",NA,"1",NA,896,652,244,229,143,67,1,10,0,8,15,1345,997,348,331,189,119,2,10,0,11,17,"-095.1662943","+29.6850797"
"840","482013231002","48",NA,"2",NA,1433,1207,226,216,135,77,0,4,0,0,10,2147,1826,321,301,165,130,2,4,0,0,20,"-095.1777800","+29.6944119"
"841","482013232001","48",NA,"1",NA,1305,963,342,321,302,8,1,7,2,1,21,1780,1398,382,351,323,12,1,11,2,2,31,"-095.1777616","+29.6883736"
"842","482013232002","48",NA,"2",NA,917,647,270,262,186,65,4,7,0,0,8,1291,935,356,348,222,107,6,13,0,0,8,"-095.1779812","+29.6837122"
"843","482013232003","48",NA,"3",NA,731,611,120,98,75,7,1,7,0,8,22,1008,852,156,133,93,15,1,12,1,11,23,"-095.1899119","+29.6853253"
"844","482013232004","48",NA,"4",NA,1099,848,251,231,205,10,4,3,0,9,20,1516,1229,287,261,233,12,4,3,0,9,26,"-095.1863764","+29.6884590"
"845","482013233001","48",NA,"1",NA,1570,1224,346,332,220,110,0,1,1,0,14,2244,1827,417,401,263,133,0,3,1,1,16,"-095.2032221","+29.6878049"
"846","482013233002","48",NA,"2",NA,823,671,152,131,123,4,0,1,3,0,21,1153,967,186,158,142,8,0,3,3,2,28,"-095.1960453","+29.6856138"
"847","482013234001","48",NA,"1",NA,1366,1091,275,266,241,12,6,6,0,1,9,1935,1611,324,313,279,20,6,7,0,1,11,"-095.1959851","+29.6788997"
"848","482013234002","48",NA,"2",NA,1031,748,283,269,200,59,2,4,0,4,14,1448,1101,347,332,257,65,2,4,0,4,15,"-095.1954394","+29.6696630"
"849","482013234003","48",NA,"3",NA,681,535,146,136,129,7,0,0,0,0,10,991,818,173,161,144,13,0,2,0,2,12,"-095.2028000","+29.6760740"
"850","482013234004","48",NA,"4",NA,1056,968,88,80,59,13,0,4,0,4,8,1568,1469,99,91,64,14,0,5,0,8,8,"-095.2065815","+29.6805560"
"851","482013234005","48",NA,"5",NA,932,750,182,165,154,9,0,1,0,1,17,1333,1121,212,193,180,10,0,2,0,1,19,"-095.2015322","+29.6804772"
"852","482013235001","48",NA,"1",NA,1179,920,259,247,157,80,0,9,0,1,12,1699,1361,338,324,176,128,1,16,0,3,14,"-095.2019454","+29.6705491"
"853","482013235002","48",NA,"2",NA,825,565,260,248,183,51,3,8,0,3,12,1166,835,331,312,206,78,12,13,0,3,19,"-095.2003440","+29.6603878"
"854","482013235003","48",NA,"3",NA,607,391,216,216,126,73,4,13,0,0,0,839,552,287,283,141,123,4,13,0,2,4,"-095.2052850","+29.6564352"
"855","482013235004","48",NA,"4",NA,1005,663,342,321,106,191,0,20,0,4,21,1645,1027,618,588,146,393,5,34,0,10,30,"-095.2055131","+29.6644841"
"856","482013236011","48",NA,"1",NA,935,584,351,346,287,36,5,16,0,2,5,1345,899,446,435,357,49,5,22,0,2,11,"-095.1962867","+29.6451651"
"857","482013236012","48",NA,"2",NA,1250,644,606,587,460,86,8,26,2,5,19,1489,801,688,663,499,118,8,29,4,5,25,"-095.1884773","+29.6548353"
"858","482013236013","48",NA,"3",NA,935,563,372,361,304,34,7,8,0,8,11,1234,788,446,429,333,68,8,8,4,8,17,"-095.1917205","+29.6615660"
"859","482013236021","48",NA,"1",NA,1337,756,581,560,393,22,3,140,0,2,21,1800,1086,714,688,468,27,3,185,0,5,26,"-095.1871909","+29.6353888"
"860","482013236022","48",NA,"2",NA,1636,894,742,726,622,42,3,53,1,5,16,2143,1297,846,823,695,53,4,63,1,7,23,"-095.1862809","+29.6432964"
"861","482013236023","48",NA,"3",NA,767,388,379,365,325,13,0,26,1,0,14,1020,571,449,430,380,15,4,28,1,2,19,"-095.1866744","+29.6486751"
"862","482013237011","48",NA,"1",NA,939,483,456,437,331,72,12,22,0,0,19,1193,660,533,501,364,89,12,33,0,3,32,"-095.1792889","+29.6619090"
"863","482013237012","48",NA,"2",NA,1476,588,888,856,749,44,7,51,0,5,32,1814,816,998,951,813,62,7,63,0,6,47,"-095.1769249","+29.6551252"
"864","482013237013","48",NA,"3",NA,1140,552,588,562,382,127,1,49,0,3,26,1413,754,659,621,414,149,1,54,0,3,38,"-095.1827095","+29.6560091"
"865","482013237021","48",NA,"1",NA,1614,788,826,794,651,107,1,31,1,3,32,2121,1129,992,939,764,138,1,32,1,3,53,"-095.1769172","+29.6471981"
"866","482013237022","48",NA,"2",NA,826,463,363,344,295,17,3,26,1,2,19,1131,696,435,406,345,24,3,29,1,4,29,"-095.1761452","+29.6423623"
"867","482013238011","48",NA,"1",NA,1627,1227,400,383,343,28,2,9,0,1,17,2271,1799,472,455,394,40,2,9,2,8,17,"-095.1886494","+29.6784457"
"868","482013238012","48",NA,"2",NA,1315,885,430,418,390,1,3,13,0,11,12,1797,1300,497,481,437,8,3,18,3,12,16,"-095.1898125","+29.6697586"
"869","482013238021","48",NA,"1",NA,1437,973,464,449,422,17,2,6,0,2,15,1979,1439,540,522,474,29,6,7,0,6,18,"-095.1758765","+29.6680905"
"870","482013238022","48",NA,"2",NA,1145,751,394,387,300,70,0,5,0,12,7,1678,1184,494,486,360,103,0,9,0,14,8,"-095.1795622","+29.6731081"
"871","482013238023","48",NA,"3",NA,962,767,195,183,170,7,2,3,1,0,12,1348,1134,214,199,180,12,3,3,1,0,15,"-095.1781844","+29.6796476"
"872","482013239001","48",NA,"1",NA,1294,794,500,475,350,121,2,1,1,0,25,1859,1225,634,607,416,186,2,1,2,0,27,"-095.1653510","+29.6784522"
"873","482013239002","48",NA,"2",NA,1445,733,712,663,602,29,7,14,0,11,49,1851,1053,798,730,661,34,7,16,1,11,68,"-095.1641285","+29.6707203"
"874","482013240001","48",NA,"1",NA,1342,769,573,548,496,15,5,32,0,0,25,1755,1088,667,633,557,31,5,40,0,0,34,"-095.1618885","+29.6592286"
"875","482013240002","48",NA,"2",NA,2314,986,1328,1283,1078,70,3,116,0,16,45,2901,1395,1506,1448,1195,87,3,139,0,24,58,"-095.1653731","+29.6465271"
"876","482013240003","48",NA,"3",NA,820,439,381,373,185,34,0,152,0,2,8,1161,669,492,472,244,49,0,174,1,4,20,"-095.1776404","+29.6287314"
"877","482013241011","48",NA,"1",NA,643,559,84,79,73,0,0,6,0,0,5,882,783,99,92,81,3,0,6,0,2,7,"-095.2190751","+29.7129938"
"878","482013241012","48",NA,"2",NA,508,388,120,119,85,31,0,0,0,3,1,705,558,147,145,98,42,0,0,0,5,2,"-095.2072904","+29.7157565"
"879","482013241013","48",NA,"3",NA,891,784,107,94,79,7,2,2,0,4,13,1229,1094,135,121,102,10,3,2,0,4,14,"-095.2055714","+29.7091221"
"880","482013241014","48",NA,"4",NA,876,766,110,93,82,7,0,4,0,0,17,1199,1057,142,123,106,10,0,5,0,2,19,"-095.2052689","+29.7035714"
"881","482013241015","48",NA,"5",NA,870,768,102,94,84,5,0,4,0,1,8,1264,1121,143,126,108,7,0,9,0,2,17,"-095.2052201","+29.6999387"
"882","482013241021","48",NA,"1",NA,0,0,0,0,0,0,0,0,0,0,0,0,0,0,0,0,0,0,0,0,0,0,"-095.1790857","+29.7313641"
"883","482013242001","48",NA,"1",NA,926,882,44,39,31,0,0,1,0,7,5,1271,1221,50,44,33,0,0,1,0,10,6,"-095.2607420","+29.7181411"
"884","482013242002","48",NA,"2",NA,7,4,3,2,0,0,2,0,0,0,1,8,5,3,2,0,0,2,0,0,0,1,"-095.2428809","+29.7152961"
"885","482013301011","48",NA,"1",NA,1655,1050,605,593,11,564,1,17,0,0,12,2281,1469,812,788,11,755,1,19,0,2,24,"-095.4244616","+29.6307174"
"886","482013301012","48",NA,"2",NA,906,541,365,357,20,326,0,11,0,0,8,1235,778,457,445,25,409,0,11,0,0,12,"-095.4262308","+29.6395610"
"887","482013301013","48",NA,"3",NA,1189,667,522,511,11,485,0,14,0,1,11,1575,930,645,631,13,599,0,16,0,3,14,"-095.4256451","+29.6359739"
"888","482013301021","48",NA,"1",NA,1941,1074,867,841,28,783,0,24,2,4,26,2703,1626,1077,1051,51,963,3,24,2,8,26,"-095.4165137","+29.6347678"
"889","482013302001","48",NA,"1",NA,1763,922,841,823,92,684,0,39,0,8,18,2415,1374,1041,1015,110,853,0,43,0,9,26,"-095.4536495","+29.6346785"
"890","482013302002","48",NA,"2",NA,1312,754,558,537,38,489,0,5,0,5,21,1875,1161,714,680,39,631,0,5,0,5,34,"-095.4616345","+29.6333188"
"891","482013303011","48",NA,"1",NA,1676,1296,380,360,71,205,1,78,0,5,20,2289,1807,482,450,92,259,1,93,0,5,32,"-095.4785170","+29.6331257"
"892","482013303012","48",NA,"2",NA,2106,1227,879,868,43,722,0,90,0,13,11,2831,1711,1120,1104,54,931,1,105,0,13,16,"-095.4694110","+29.6309367"
"893","482013303013","48",NA,"3",NA,1988,1373,615,598,69,429,1,93,0,6,17,2821,1942,879,859,88,640,1,116,0,14,20,"-095.4709368","+29.6404142"
"894","482013303021","48",NA,"1",NA,1782,1472,310,300,58,222,1,19,0,0,10,2498,2009,489,475,72,377,1,20,2,3,14,"-095.4739541","+29.6114004"
"895","482013303022","48",NA,"2",NA,986,524,462,445,44,392,0,9,0,0,17,1307,771,536,518,44,462,0,9,1,2,18,"-095.4700076","+29.6197629"
"896","482013303023","48",NA,"3",NA,1486,659,827,814,33,763,8,10,0,0,13,1908,912,996,979,44,907,8,16,1,3,17,"-095.4813003","+29.6201850"
"897","482013303031","48",NA,"1",NA,1013,643,370,360,39,306,0,8,0,7,10,1520,969,551,540,46,476,0,9,0,9,11,"-095.4998470","+29.6299086"
"898","482013303032","48",NA,"2",NA,1345,686,659,646,103,515,0,23,0,5,13,1764,958,806,788,111,643,0,28,0,6,18,"-095.5038295","+29.6221940"
"899","482013303033","48",NA,"3",NA,1031,243,788,783,32,733,0,12,0,6,5,1231,317,914,904,42,842,0,12,0,8,10,"-095.4874974","+29.6318499"
"900","482013304001","48",NA,"1",NA,1022,784,238,230,30,180,0,16,1,3,8,1443,1137,306,296,40,234,0,17,1,4,10,"-095.4529364","+29.6240596"
"901","482013304002","48",NA,"2",NA,1318,842,476,471,50,408,3,5,0,5,5,1819,1200,619,611,56,541,3,5,0,6,8,"-095.4598487","+29.6188512"
"902","482013304003","48",NA,"3",NA,1146,400,746,728,23,697,3,5,0,0,18,1601,589,1012,987,23,952,7,5,0,0,25,"-095.4558205","+29.6099364"
"903","482013305001","48",NA,"1",NA,1648,897,751,732,75,555,4,91,0,7,19,2291,1351,940,916,84,714,4,107,0,7,24,"-095.4251824","+29.6229046"
"904","482013305002","48",NA,"2",NA,1013,572,441,430,32,387,2,1,0,8,11,1390,801,589,566,42,507,2,7,0,8,23,"-095.4335425","+29.6228750"
"905","482013305003","48",NA,"3",NA,837,435,402,389,23,362,2,0,0,2,13,1064,587,477,454,25,420,6,1,0,2,23,"-095.4406113","+29.6247348"
"906","482013306001","48",NA,"1",NA,1218,545,673,651,29,607,0,9,0,6,22,1718,813,905,876,30,827,2,9,0,8,29,"-095.4250732","+29.6168537"
"907","482013306002","48",NA,"2",NA,1750,704,1046,1033,81,882,0,57,0,13,13,2438,992,1446,1428,97,1253,0,65,0,13,18,"-095.4314192","+29.6099717"
"908","482013306003","48",NA,"3",NA,596,242,354,346,25,317,0,2,2,0,8,776,352,424,415,25,385,0,2,2,1,9,"-095.4439302","+29.6097156"
"909","482013306004","48",NA,"4",NA,1596,766,830,821,51,758,1,8,2,1,9,2207,1135,1072,1051,56,983,1,8,2,1,21,"-095.4370219","+29.6149921"
"910","482013307001","48",NA,"1",NA,1253,817,436,429,14,411,1,3,0,0,7,1673,1134,539,526,22,498,2,4,0,0,13,"-095.4555170","+29.6010353"
"911","482013307002","48",NA,"2",NA,1046,788,258,242,20,205,3,11,0,3,16,1488,1145,343,324,20,282,4,12,0,6,19,"-095.4600532","+29.6027544"
"912","482013307003","48",NA,"3",NA,1804,1112,692,681,126,509,0,44,0,2,11,2633,1719,914,898,153,678,1,56,0,10,16,"-095.4338060","+29.6011799"
"913","482013307004","48",NA,"4",NA,1871,1315,556,538,38,481,3,8,1,7,18,3003,2107,896,869,52,788,5,16,1,7,27,"-095.4370867","+29.5923470"
"914","482013308011","48",NA,"1",NA,2362,683,1679,1639,193,1264,0,178,1,3,40,3427,1051,2376,2325,226,1878,4,213,1,3,51,"-095.3264861","+29.6019314"
"915","482013308012","48",NA,"2",NA,1784,1188,596,568,95,436,0,30,1,6,28,2709,1871,838,801,111,629,1,49,1,10,37,"-095.3242461","+29.6120753"
"916","482013308021","48",NA,"1",NA,1370,341,1029,1003,68,857,7,55,0,16,26,1914,491,1423,1363,82,1188,11,64,0,18,60,"-095.3606992","+29.6069147"
"917","482013308022","48",NA,"2",NA,2819,600,2219,2163,198,1802,2,157,0,4,56,3945,926,3019,2924,221,2509,5,184,0,5,95,"-095.3740563","+29.6063157"
"918","482013308023","48",NA,"3",NA,1397,339,1058,1012,167,789,0,47,0,9,46,1758,460,1298,1241,182,987,0,63,0,9,57,"-095.3919420","+29.5899441"
"919","482013308024","48",NA,"4",NA,1204,170,1034,1026,61,927,0,37,0,1,8,1854,289,1565,1548,66,1437,0,43,0,2,17,"-095.3631031","+29.6021003"
"920","482013309011","48",NA,"1",NA,2782,624,2158,2088,292,1452,3,314,1,26,70,3819,938,2881,2782,354,2003,4,382,1,38,99,"-095.3996736","+29.6265356"
"921","482013309012","48",NA,"2",NA,1979,593,1386,1350,45,1243,0,56,1,5,36,2837,898,1939,1873,53,1742,1,68,1,8,66,"-095.4096430","+29.6185681"
"922","482013309013","48",NA,"3",NA,2220,379,1841,1795,254,1292,6,232,2,9,46,2871,516,2355,2295,291,1711,8,263,2,20,60,"-095.3938776","+29.6195322"
"923","482013309021","48",NA,"1",NA,1091,881,210,206,77,123,0,3,2,1,4,1643,1391,252,245,85,150,0,3,2,5,7,"-095.4007576","+29.6077289"
"924","482013309022","48",NA,"2",NA,1355,1180,175,173,62,105,0,2,2,2,2,2180,1965,215,207,71,129,0,2,2,3,8,"-095.4163408","+29.6020369"
"925","482013311001","48",NA,"1",NA,1141,171,970,946,24,904,3,10,1,4,24,1591,242,1349,1322,26,1276,5,10,1,4,27,"-095.3773870","+29.6724122"
"926","482013311002","48",NA,"2",NA,1325,242,1083,1057,42,1004,2,3,0,6,26,1718,363,1355,1315,50,1251,5,3,0,6,40,"-095.3707271","+29.6759517"
"927","482013311003","48",NA,"3",NA,946,285,661,648,38,600,1,5,1,3,13,1301,449,852,829,38,778,2,7,1,3,23,"-095.3599217","+29.6753370"
"928","482013312001","48",NA,"1",NA,1385,222,1163,1148,24,1102,7,7,0,8,15,1853,332,1521,1497,29,1442,7,8,1,10,24,"-095.3595876","+29.6634591"
"929","482013312002","48",NA,"2",NA,983,110,873,853,25,818,2,3,0,5,20,1317,168,1149,1112,34,1067,3,3,0,5,37,"-095.3667600","+29.6643738"
"930","482013312003","48",NA,"3",NA,746,57,689,674,37,631,5,1,0,0,15,1271,130,1141,1106,58,1040,6,1,1,0,35,"-095.3779878","+29.6631385"
"931","482013313001","48",NA,"1",NA,1229,141,1088,1072,11,1056,1,4,0,0,16,1658,241,1417,1395,13,1377,1,4,0,0,22,"-095.3810172","+29.6521377"
"932","482013313002","48",NA,"2",NA,804,154,650,642,11,628,0,3,0,0,8,1042,240,802,787,22,761,0,3,0,1,15,"-095.3703429","+29.6486118"
"933","482013313003","48",NA,"3",NA,612,67,545,542,4,536,0,0,0,2,3,754,108,646,638,5,631,0,0,0,2,8,"-095.3827009","+29.6365158"
"934","482013313004","48",NA,"4",NA,1210,204,1006,987,17,957,4,4,0,5,19,1578,313,1265,1238,18,1205,4,6,0,5,27,"-095.3767061","+29.6469456"
"935","482013314001","48",NA,"1",NA,1013,63,950,936,9,909,3,13,0,2,14,1711,99,1612,1583,15,1545,7,14,0,2,29,"-095.3666768","+29.6525445"
"936","482013314002","48",NA,"2",NA,653,22,631,622,2,614,3,3,0,0,9,827,25,802,791,4,779,3,5,0,0,11,"-095.3601789","+29.6543860"
"937","482013315011","48",NA,"1",NA,1281,191,1090,1074,17,1053,0,3,0,1,16,1677,303,1374,1347,20,1323,0,3,0,1,27,"-095.3614928","+29.6417830"
"938","482013315012","48",NA,"2",NA,1753,144,1609,1577,13,1553,4,3,0,4,32,2231,254,1977,1938,23,1904,4,3,0,4,39,"-095.3595801","+29.6289360"
"939","482013315021","48",NA,"1",NA,2014,178,1836,1791,25,1745,0,4,0,17,45,2634,273,2361,2302,31,2248,0,4,0,19,59,"-095.3661314","+29.6331218"
"940","482013315022","48",NA,"2",NA,1926,659,1267,1227,173,930,0,119,1,4,40,2725,1004,1721,1661,207,1291,0,156,1,6,60,"-095.3733149","+29.6305535"
"941","482013316021","48",NA,"1",NA,1345,439,906,884,52,806,7,16,0,3,22,2032,669,1363,1326,55,1234,7,18,0,12,37,"-095.3182656","+29.6278814"
"942","482013316022","48",NA,"2",NA,563,90,473,472,14,444,3,11,0,0,1,861,128,733,727,25,686,3,11,0,2,6,"-095.3345979","+29.6339031"
"943","482013316023","48",NA,"3",NA,489,26,463,459,3,451,1,0,0,4,4,711,44,667,657,3,644,1,2,0,7,10,"-095.3355113","+29.6275159"
"944","482013316031","48",NA,"1",NA,1032,242,790,776,11,754,4,3,1,3,14,1336,334,1002,985,13,956,5,7,1,3,17,"-095.3523341","+29.6349202"
"945","482013316032","48",NA,"2",NA,428,36,392,389,0,387,0,0,0,2,3,537,55,482,479,0,477,0,0,0,2,3,"-095.3512079","+29.6291795"
"946","482013316033","48",NA,"3",NA,1824,190,1634,1610,17,1567,0,14,2,10,24,2326,314,2012,1985,20,1934,0,19,2,10,27,"-095.3485755","+29.6228293"
"947","482013316041","48",NA,"1",NA,665,43,622,615,8,606,0,0,1,0,7,934,72,862,850,9,839,0,0,1,1,12,"-095.3427234","+29.6293379"
"948","482013316042","48",NA,"2",NA,784,80,704,701,5,688,7,0,0,1,3,995,136,859,853,7,834,7,2,0,3,6,"-095.3451769","+29.6310822"
"949","482013316043","48",NA,"3",NA,497,63,434,421,9,409,0,1,1,1,13,613,106,507,492,14,475,0,1,1,1,15,"-095.3438276","+29.6349312"
"950","482013317001","48",NA,"1",NA,1090,287,803,786,14,759,2,9,0,2,17,1793,491,1302,1273,17,1241,2,9,0,4,29,"-095.3268590","+29.6435260"
"951","482013317002","48",NA,"2",NA,712,85,627,617,6,611,0,0,0,0,10,891,120,771,758,8,748,0,2,0,0,13,"-095.3431552","+29.6392286"
"952","482013317003","48",NA,"3",NA,1040,164,876,859,9,844,3,0,0,3,17,1371,265,1106,1088,14,1062,3,0,1,8,18,"-095.3518042","+29.6437941"
"953","482013318001","48",NA,"1",NA,777,251,526,516,22,483,0,6,0,5,10,1078,382,696,683,24,646,0,6,0,7,13,"-095.3440214","+29.6486875"
"954","482013318002","48",NA,"2",NA,837,98,739,729,9,711,1,0,0,8,10,1285,179,1106,1092,11,1071,2,0,0,8,14,"-095.3521906","+29.6544504"
"955","482013318003","48",NA,"3",NA,1151,218,933,919,18,895,2,4,0,0,14,1505,353,1152,1133,19,1099,5,8,0,2,19,"-095.3427492","+29.6549221"
"956","482013319001","48",NA,"1",NA,743,136,607,600,17,575,1,3,0,4,7,1003,226,777,767,18,736,3,6,0,4,10,"-095.3523939","+29.6631164"
"957","482013319002","48",NA,"2",NA,1032,221,811,796,11,784,0,0,0,1,15,1356,355,1001,979,14,963,1,0,0,1,22,"-095.3416028","+29.6640096"
"958","482013319003","48",NA,"3",NA,784,94,690,677,13,662,0,0,0,2,13,995,148,847,829,13,813,1,0,0,2,18,"-095.3441338","+29.6609200"
"959","482013320001","48",NA,"1",NA,2092,761,1331,1301,15,1270,0,4,1,11,30,2849,1174,1675,1636,20,1591,0,9,1,15,39,"-095.3419062","+29.6706999"
"960","482013320002","48",NA,"2",NA,2068,380,1688,1659,37,1586,0,26,0,10,29,3185,636,2549,2506,38,2428,1,27,0,12,43,"-095.3510803","+29.6736726"
"961","482013321001","48",NA,"1",NA,1063,608,455,442,8,430,0,1,1,2,13,1492,967,525,510,9,497,0,1,1,2,15,"-095.3475510","+29.6810159"
"962","482013321002","48",NA,"2",NA,1044,492,552,541,16,517,0,4,1,3,11,1462,777,685,672,17,647,0,4,1,3,13,"-095.3404509","+29.6795938"
"963","482013322001","48",NA,"1",NA,1291,719,572,556,13,527,2,14,0,0,16,1787,1092,695,671,15,637,2,17,0,0,24,"-095.3310009","+29.6866799"
"964","482013322002","48",NA,"2",NA,1796,799,997,968,28,921,4,5,0,10,29,2364,1172,1192,1147,34,1092,4,7,0,10,45,"-095.3284489","+29.6779198"
"965","482013322003","48",NA,"3",NA,553,266,287,281,4,270,3,0,0,4,6,770,404,366,351,4,340,3,0,0,4,15,"-095.3376618","+29.6825549"
"966","482013323001","48",NA,"1",NA,1037,286,751,737,5,723,0,7,0,2,14,1344,440,904,888,7,871,0,7,0,3,16,"-095.3236595","+29.6692113"
"967","482013323002","48",NA,"2",NA,1253,411,842,827,23,799,0,3,0,2,15,1655,604,1051,1033,24,1002,0,5,0,2,18,"-095.3230674","+29.6639073"
"968","482013324001","48",NA,"1",NA,1043,232,811,806,20,774,1,3,0,8,5,1353,377,976,961,23,926,1,3,0,8,15,"-095.3329390","+29.6683557"
"969","482013324002","48",NA,"2",NA,1297,243,1054,1035,26,999,3,0,0,7,19,1630,344,1286,1264,34,1220,3,0,0,7,22,"-095.3326523","+29.6617121"
"970","482013324003","48",NA,"3",NA,841,112,729,720,16,702,1,0,0,1,9,1077,193,884,871,23,846,1,0,0,1,13,"-095.3296356","+29.6535262"
"971","482013325001","48",NA,"1",NA,1418,655,763,744,47,690,3,2,0,2,19,1842,947,895,862,47,808,3,2,0,2,33,"-095.3136223","+29.6610794"
"972","482013325002","48",NA,"2",NA,1040,551,489,482,31,434,0,9,0,8,7,1348,779,569,560,35,508,0,9,0,8,9,"-095.3034481","+29.6677086"
"973","482013326001","48",NA,"1",NA,930,837,93,82,54,28,0,0,0,0,11,1243,1138,105,91,54,36,0,0,0,1,14,"-095.3012502","+29.6799865"
"974","482013326002","48",NA,"2",NA,1701,1069,632,625,62,541,2,16,3,1,7,2212,1476,736,723,71,621,2,18,3,8,13,"-095.2984095","+29.6756286"
"975","482013326003","48",NA,"3",NA,1365,771,594,582,46,525,0,5,0,6,12,1879,1127,752,735,58,665,0,5,0,7,17,"-095.3134911","+29.6739335"
"976","482013326004","48",NA,"4",NA,919,375,544,524,13,510,1,0,0,0,20,1243,585,658,635,19,615,1,0,0,0,23,"-095.3054430","+29.6718148"
"977","482013327001","48",NA,"1",NA,562,488,74,73,32,37,1,3,0,0,1,749,672,77,76,33,39,1,3,0,0,1,"-095.3003386","+29.6832359"
"978","482013327002","48",NA,"2",NA,1288,1133,155,143,79,47,5,9,0,3,12,1724,1529,195,174,102,53,5,9,0,5,21,"-095.3165281","+29.6854361"
"979","482013328001","48",NA,"1",NA,789,474,315,304,97,189,0,9,0,9,11,1041,696,345,333,106,208,0,10,0,9,12,"-095.3149881","+29.6939044"
"980","482013328002","48",NA,"2",NA,758,682,76,69,20,43,0,0,0,6,7,1054,939,115,107,26,71,2,2,0,6,8,"-095.3045390","+29.6948163"
"981","482013328003","48",NA,"3",NA,1354,1109,245,242,80,160,1,0,0,1,3,1867,1504,363,358,87,267,1,0,0,3,5,"-095.3077088","+29.6897770"
"982","482013329001","48",NA,"1",NA,1952,1599,353,344,205,93,1,29,0,16,9,2626,2157,469,455,285,107,4,37,0,22,14,"-095.2882412","+29.6883750"
"983","482013329002","48",NA,"2",NA,721,625,96,92,33,57,0,0,0,2,4,1030,893,137,133,54,77,0,0,0,2,4,"-095.2963926","+29.6935500"
"984","482013329003","48",NA,"3",NA,867,772,95,93,40,46,0,6,0,1,2,1229,1083,146,139,57,74,0,6,0,2,7,"-095.2918092","+29.6931215"
"985","482013330001","48",NA,"1",NA,1829,1580,249,233,146,52,0,23,0,12,16,2405,2119,286,264,161,62,0,26,0,15,22,"-095.2891064","+29.6819562"
"986","482013330002","48",NA,"2",NA,609,512,97,89,54,25,0,8,0,2,8,885,756,129,115,64,33,0,9,0,9,14,"-095.2804286","+29.6805637"
"987","482013331001","48",NA,"1",NA,1224,704,520,512,146,311,0,48,1,6,8,1684,1069,615,606,150,378,3,63,1,11,9,"-095.2835205","+29.6744912"
"988","482013331002","48",NA,"2",NA,601,318,283,271,96,139,1,31,0,4,12,782,427,355,343,119,181,4,34,0,5,12,"-095.2731167","+29.6752782"
"989","482013331003","48",NA,"3",NA,1058,189,869,856,75,47,0,730,0,4,13,1327,264,1063,1047,85,53,0,905,0,4,16,"-095.2786693","+29.6765273"
"990","482013332011","48",NA,"1",NA,1402,853,549,543,68,445,2,28,0,0,6,1944,1203,741,734,69,631,2,32,0,0,7,"-095.2684848","+29.6710605"
"991","482013332012","48",NA,"2",NA,819,611,208,198,89,78,11,20,0,0,10,1117,865,252,235,100,94,12,27,0,2,17,"-095.2669882","+29.6677237"
"992","482013332013","48",NA,"3",NA,641,292,349,347,29,298,0,20,0,0,2,849,405,444,439,37,380,0,21,0,1,5,"-095.2744368","+29.6672273"
"993","482013332014","48",NA,"4",NA,618,480,138,137,30,71,5,30,0,1,1,908,735,173,170,36,87,5,36,0,6,3,"-095.2745960","+29.6705986"
"994","482013332031","48",NA,"1",NA,762,564,198,189,89,80,1,19,0,0,9,1022,779,243,232,104,102,1,25,0,0,11,"-095.2606730","+29.6590171"
"995","482013332032","48",NA,"2",NA,888,483,405,394,85,270,4,26,0,9,11,1141,646,495,472,98,335,4,26,0,9,23,"-095.2703397","+29.6621677"
"996","482013332041","48",NA,"1",NA,489,252,237,235,8,214,0,4,1,8,2,658,354,304,301,14,267,0,6,1,13,3,"-095.2734361","+29.6597023"
"997","482013332042","48",NA,"2",NA,459,252,207,200,19,179,0,2,0,0,7,622,365,257,247,26,218,0,2,0,1,10,"-095.2756313","+29.6596620"
"998","482013332051","48",NA,"1",NA,592,310,282,276,15,242,1,16,0,2,6,820,463,357,348,15,312,2,17,0,2,9,"-095.2745147","+29.6620220"
"999","482013332052","48",NA,"2",NA,523,209,314,309,43,264,0,0,0,2,5,695,305,390,384,44,337,0,1,0,2,6,"-095.2753762","+29.6638297"
"1000","482013333011","48",NA,"1",NA,1053,596,457,443,24,409,3,4,0,3,14,1716,931,785,762,48,696,3,9,0,6,23,"-095.2448294","+29.6332557"
"1001","482013333012","48",NA,"2",NA,544,296,248,236,34,169,0,33,0,0,12,758,435,323,304,38,212,0,50,0,4,19,"-095.2393821","+29.6303295"
"1002","482013333013","48",NA,"3",NA,2113,1144,969,925,142,697,18,54,1,13,44,3219,1825,1394,1333,171,1060,21,65,1,15,61,"-095.2422843","+29.6369695"
"1003","482013333021","48",NA,"1",NA,1008,792,216,204,96,74,4,27,2,1,12,1454,1172,282,268,118,112,4,31,2,1,14,"-095.2559675","+29.6455686"
"1004","482013333022","48",NA,"2",NA,1602,1349,253,241,84,69,0,83,3,2,12,2207,1907,300,287,100,89,0,93,3,2,13,"-095.2570651","+29.6324749"
"1005","482013335011","48",NA,"1",NA,1080,771,309,291,52,224,0,10,1,4,18,1500,1098,402,383,57,305,3,11,1,6,19,"-095.2823092","+29.6604228"
"1006","482013335012","48",NA,"2",NA,1349,1029,320,307,66,206,0,33,0,2,13,1943,1570,373,359,69,251,0,37,0,2,14,"-095.2792655","+29.6687698"
"1007","482013335021","48",NA,"1",NA,673,535,138,138,46,89,0,3,0,0,0,1042,853,189,186,53,130,0,3,0,0,3,"-095.2856633","+29.6638270"
"1008","482013335022","48",NA,"2",NA,1156,775,381,364,114,226,4,20,0,0,17,1579,1137,442,421,124,269,5,23,0,0,21,"-095.2844671","+29.6681887"
"1009","482013336001","48",NA,"1",NA,887,564,323,313,207,89,0,12,0,5,10,1198,819,379,369,226,114,2,20,0,7,10,"-095.2915467","+29.6674844"
"1010","482013336002","48",NA,"2",NA,746,503,243,236,167,57,0,4,0,8,7,949,681,268,261,176,68,5,4,0,8,7,"-095.2999617","+29.6571555"
"1011","482013336003","48",NA,"3",NA,794,500,294,283,196,79,0,7,0,1,11,1068,728,340,326,217,97,0,11,0,1,14,"-095.3066565","+29.6550889"
"1012","482013337001","48",NA,"1",NA,1522,1182,340,330,118,123,1,84,0,4,10,2052,1672,380,365,127,143,1,90,0,4,15,"-095.2762482","+29.6304024"
"1013","482013337002","48",NA,"2",NA,993,815,178,175,82,57,2,28,0,6,3,1390,1177,213,209,94,72,2,35,0,6,4,"-095.2973971","+29.6369985"
"1014","482013338011","48",NA,"1",NA,794,658,136,129,37,83,0,9,0,0,7,1163,991,172,163,40,108,0,13,0,2,9,"-095.2836965","+29.6174817"
"1015","482013338012","48",NA,"2",NA,653,462,191,181,61,87,1,30,0,2,10,887,670,217,205,64,107,1,31,0,2,12,"-095.2797608","+29.6153028"
"1016","482013338013","48",NA,"3",NA,1445,1318,127,118,61,36,0,21,0,0,9,2138,1982,156,144,76,45,0,22,0,1,12,"-095.2911513","+29.6177853"
"1017","482013338021","48",NA,"1",NA,1442,910,532,516,114,361,2,35,2,2,16,1855,1226,629,611,133,429,3,41,2,3,18,"-095.2711224","+29.6110717"
"1018","482013338022","48",NA,"2",NA,1492,770,722,712,129,551,1,27,0,4,10,2090,1136,954,927,156,735,1,31,0,4,27,"-095.2769384","+29.6060436"
"1019","482013338023","48",NA,"3",NA,1405,1144,261,257,101,91,0,59,0,6,4,1852,1543,309,300,120,104,2,68,0,6,9,"-095.2713451","+29.6210793"
"1020","482013339031","48",NA,"1",NA,1315,763,552,539,156,348,0,30,2,3,13,1931,1140,791,773,176,552,0,37,2,6,18,"-095.2403415","+29.6164435"
"1021","482013339032","48",NA,"2",NA,1249,853,396,373,89,88,1,191,0,4,23,1758,1224,534,498,123,126,1,244,0,4,36,"-095.2321406","+29.6225364"
"1022","482013339041","48",NA,"1",NA,929,631,298,273,184,45,2,42,0,0,25,1332,965,367,332,199,65,2,59,0,7,35,"-095.2460818","+29.6151654"
"1023","482013339042","48",NA,"2",NA,1517,941,576,559,166,185,4,186,0,18,17,1929,1264,665,635,196,212,5,201,0,21,30,"-095.2464583","+29.6067071"
"1024","482013339043","48",NA,"3",NA,1341,411,930,901,154,641,7,97,0,2,29,1797,580,1217,1176,165,874,7,128,0,2,41,"-095.2428203","+29.6219773"
"1025","482013339051","48",NA,"1",NA,622,402,220,204,50,50,0,102,0,2,16,921,613,308,283,68,67,1,136,2,9,25,"-095.2600034","+29.6214609"
"1026","482013339052","48",NA,"2",NA,2296,1361,935,926,124,285,0,508,0,9,9,3238,2016,1222,1203,156,391,0,645,0,11,19,"-095.2582346","+29.6151216"
"1027","482013339061","48",NA,"1",NA,731,533,198,191,22,69,1,93,0,6,7,1082,816,266,249,31,86,2,122,0,8,17,"-095.2637646","+29.6082898"
"1028","482013339062","48",NA,"2",NA,1366,665,701,692,95,170,1,418,0,8,9,1778,919,859,841,105,217,1,507,0,11,18,"-095.2519302","+29.6054655"
"1029","482013339063","48",NA,"3",NA,1621,1024,597,581,83,171,3,314,0,10,16,2287,1522,765,742,106,227,3,391,0,15,23,"-095.2592896","+29.6046151"
"1030","482013340011","48",NA,"1",NA,1277,674,603,585,188,228,9,156,0,4,18,1798,997,801,766,214,351,10,176,0,15,35,"-095.2292794","+29.6142710"
"1031","482013340012","48",NA,"2",NA,1310,317,993,980,64,456,0,456,0,4,13,1909,509,1400,1378,74,713,1,586,0,4,22,"-095.2215256","+29.6157459"
"1032","482013340021","48",NA,"1",NA,852,326,526,513,186,272,0,47,0,8,13,1096,442,654,636,206,366,0,56,0,8,18,"-095.2135827","+29.6081198"
"1033","482013340022","48",NA,"2",NA,904,299,605,578,185,335,7,43,0,8,27,1144,390,754,710,200,443,7,52,0,8,44,"-095.2186553","+29.6122543"
"1034","482013340031","48",NA,"1",NA,1525,835,690,670,433,110,0,120,0,7,20,1974,1168,806,774,486,139,0,142,0,7,32,"-095.2219970","+29.6043621"
"1035","482013340032","48",NA,"2",NA,873,324,549,543,128,379,0,36,0,0,6,1143,448,695,683,135,498,0,49,0,1,12,"-095.2257189","+29.6084771"
"1036","482013340033","48",NA,"3",NA,1004,527,477,452,206,168,0,76,0,2,25,1325,738,587,547,234,215,0,91,0,7,40,"-095.2306953","+29.6044947"
"1037","482013340034","48",NA,"4",NA,1467,839,628,588,313,95,1,172,0,7,40,1907,1165,742,690,352,121,1,207,0,9,52,"-095.2363093","+29.6063640"
"1038","482013341011","48",NA,"1",NA,1472,168,1304,1247,208,915,1,119,0,4,57,1711,219,1492,1430,224,1067,1,132,0,6,62,"-095.4223047","+29.6743026"
"1039","482013341012","48",NA,"2",NA,2556,342,2214,2135,544,1063,4,517,0,7,79,2937,409,2528,2428,603,1213,4,597,0,11,100,"-095.4301383","+29.6674223"
"1040","482013341013","48",NA,"3",NA,1985,317,1668,1594,211,1086,0,273,5,19,74,2643,450,2193,2099,235,1513,0,317,5,29,94,"-095.4011015","+29.6527608"
"1041","482013341021","48",NA,"1",NA,883,328,555,539,20,503,0,13,3,0,16,1126,446,680,660,25,604,1,26,3,1,20,"-095.4391548","+29.6311798"
"1042","482013341022","48",NA,"2",NA,2559,1012,1547,1519,306,990,2,213,0,8,28,3470,1545,1925,1883,329,1294,2,238,0,20,42,"-095.4199215","+29.6490119"
"1043","482013341023","48",NA,"3",NA,841,394,447,434,26,401,4,3,0,0,13,1107,566,541,521,32,477,4,3,0,5,20,"-095.4439935","+29.6326220"
"1044","482013341024","48",NA,"4",NA,1276,291,985,959,14,927,0,15,0,3,26,1648,460,1188,1155,20,1112,0,19,0,4,33,"-095.4401862","+29.6382560"
"1045","482013401011","48",NA,"1",NA,1393,365,1028,980,284,447,2,233,0,14,48,1879,500,1379,1297,330,621,4,320,0,22,82,"-095.1761490","+29.5841992"
"1046","482013401021","48",NA,"1",NA,2575,1232,1343,1285,342,382,0,553,1,7,58,3823,1967,1856,1764,441,555,0,759,2,7,92,"-095.1960621","+29.6084233"
"1047","482013401022","48",NA,"2",NA,1206,504,702,658,403,175,3,74,0,3,44,1572,720,852,794,478,223,3,87,0,3,58,"-095.1839995","+29.5940423"
"1048","482013402011","48",NA,"1",NA,0,0,0,0,0,0,0,0,0,0,0,0,0,0,0,0,0,0,0,0,0,0,"-095.1613028","+29.6111768"
"1049","482013402021","48",NA,"1",NA,1714,266,1448,1380,955,49,4,359,0,13,68,2220,389,1831,1728,1206,71,4,431,0,16,103,"-095.1393907","+29.5998791"
"1050","482013402022","48",NA,"2",NA,2917,400,2517,2410,1439,106,2,849,4,10,107,3841,569,3272,3095,1845,117,2,1114,4,13,177,"-095.1253226","+29.6148689"
"1051","482013402023","48",NA,"3",NA,1455,266,1189,1159,780,83,1,294,0,1,30,1850,368,1482,1436,950,99,1,383,0,3,46,"-095.1489217","+29.6186066"
"1052","482013402031","48",NA,"1",NA,1636,167,1469,1409,1038,33,0,338,0,0,60,1987,235,1752,1664,1204,35,1,419,0,5,88,"-095.1037161","+29.6178351"
"1053","482013402032","48",NA,"2",NA,1979,219,1760,1692,1378,84,4,225,0,1,68,2447,304,2143,2037,1609,105,4,316,0,3,106,"-095.0959245","+29.5911563"
"1054","482013403011","48",NA,"1",NA,1297,125,1172,1154,872,39,2,232,0,9,18,1578,166,1412,1374,1026,46,2,286,0,14,38,"-095.1290596","+29.5953256"
"1055","482013403012","48",NA,"2",NA,1906,142,1764,1677,1180,48,1,446,0,2,87,2328,197,2131,2005,1436,53,1,508,0,7,126,"-095.1253776","+29.5935324"
"1056","482013403021","48",NA,"1",NA,2291,284,2007,1919,1693,43,5,166,0,12,88,2945,447,2498,2348,2071,57,7,194,0,19,150,"-095.1103619","+29.5910667"
"1057","482013403022","48",NA,"2",NA,1431,147,1284,1235,944,25,1,263,0,2,49,1840,217,1623,1549,1178,34,4,331,0,2,74,"-095.1114080","+29.6049783"
"1058","482013403023","48",NA,"3",NA,1524,250,1274,1214,1045,30,0,135,0,4,60,1976,383,1593,1496,1266,41,3,177,0,9,97,"-095.1155966","+29.5990415"
"1059","482013404001","48",NA,"1",NA,1080,103,977,929,795,16,2,105,2,9,48,1306,150,1156,1091,927,21,2,125,2,14,65,"-095.1121620","+29.5814459"
"1060","482013405011","48",NA,"1",NA,905,182,723,682,547,66,3,59,0,7,41,1140,284,856,800,632,74,3,84,0,7,56,"-095.1173754","+29.5677427"
"1061","482013405012","48",NA,"2",NA,692,217,475,439,266,77,0,94,0,2,36,816,269,547,503,301,90,1,109,0,2,44,"-095.1130559","+29.5715150"
"1062","482013405013","48",NA,"3",NA,942,173,769,726,640,57,5,19,0,5,43,1193,260,933,872,755,84,5,21,0,7,61,"-095.1223131","+29.5710684"
"1063","482013405014","48",NA,"4",NA,616,129,487,462,404,38,0,14,0,6,25,755,175,580,539,467,48,3,14,0,7,41,"-095.1285137","+29.5674134"
"1064","482013405021","48",NA,"1",NA,711,280,431,412,264,106,1,40,0,1,19,944,413,531,499,307,138,1,51,0,2,32,"-095.1182830","+29.5597198"
"1065","482013405022","48",NA,"2",NA,703,284,419,390,281,82,0,27,0,0,29,1007,475,532,497,355,112,0,30,0,0,35,"-095.1211350","+29.5618319"
"1066","482013405023","48",NA,"3",NA,606,401,205,188,121,44,1,19,0,3,17,927,662,265,235,149,62,1,20,0,3,30,"-095.1245415","+29.5614000"
"1067","482013406001","48",NA,"1",NA,1217,183,1034,997,868,47,1,69,3,9,37,1555,275,1280,1211,1040,60,1,88,7,15,69,"-095.1288759","+29.5764228"
"1068","482013406002","48",NA,"2",NA,791,126,665,630,563,28,0,20,2,17,35,1008,206,802,756,677,33,0,24,4,18,46,"-095.1350786","+29.5749619"
"1069","482013407011","48",NA,"1",NA,1463,440,1023,963,825,48,3,72,0,15,60,1840,621,1219,1142,981,55,6,83,0,17,77,"-095.1332984","+29.5578584"
"1070","482013407012","48",NA,"2",NA,1690,492,1198,1153,734,114,3,292,4,6,45,2215,694,1521,1453,904,150,6,380,5,8,68,"-095.1277932","+29.5589485"
"1071","482013407021","48",NA,"1",NA,1381,317,1064,1006,720,111,7,157,0,11,58,1787,451,1336,1241,868,157,9,185,3,19,95,"-095.1412578","+29.5676752"
"1072","482013407022","48",NA,"2",NA,914,173,741,702,554,55,5,86,0,2,39,1174,253,921,868,694,71,5,96,0,2,53,"-095.1395111","+29.5717923"
"1073","482013408001","48",NA,"1",NA,1453,231,1222,1165,879,48,0,224,0,14,57,1814,319,1495,1396,1052,59,0,269,0,16,99,"-095.1490131","+29.5778915"
"1074","482013408002","48",NA,"2",NA,1237,199,1038,996,748,38,8,195,2,5,42,1607,310,1297,1239,953,50,8,221,2,5,58,"-095.1372067","+29.5823853"
"1075","482013408003","48",NA,"3",NA,1610,294,1316,1266,943,69,8,232,0,14,50,2159,455,1704,1602,1180,86,9,313,0,14,102,"-095.1413659","+29.5862460"
"1076","482013409001","48",NA,"1",NA,1292,384,908,840,488,245,5,82,3,17,68,1810,608,1202,1097,585,370,5,115,5,17,105,"-095.1464660","+29.5628130"
"1077","482013409002","48",NA,"2",NA,450,99,351,332,210,81,2,37,0,2,19,534,125,409,384,237,101,2,42,0,2,25,"-095.1554615","+29.5739175"
"1078","482013409003","48",NA,"3",NA,958,273,685,653,359,169,0,123,0,2,32,1235,367,868,823,418,209,0,194,0,2,45,"-095.1486880","+29.5676546"
"1079","482013409004","48",NA,"4",NA,788,282,506,480,292,131,3,54,0,0,26,958,386,572,540,337,144,3,54,2,0,32,"-095.1562982","+29.5624099"
"1080","482013410011","48",NA,"1",NA,861,252,609,582,340,171,0,64,0,7,27,1014,298,716,687,383,222,0,75,0,7,29,"-095.1409923","+29.5590185"
"1081","482013410012","48",NA,"2",NA,1039,319,720,688,399,199,4,75,2,9,32,1327,439,888,843,468,270,4,87,2,12,45,"-095.1374257","+29.5553430"
"1082","482013410013","48",NA,"3",NA,1321,241,1080,1033,725,159,8,134,0,7,47,1616,351,1265,1208,810,201,13,173,0,11,57,"-095.1349129","+29.5488656"
"1083","482013410021","48",NA,"1",NA,1307,312,995,939,663,174,4,95,1,2,56,1623,431,1192,1114,757,229,4,118,1,5,78,"-095.1440916","+29.5555236"
"1084","482013410022","48",NA,"2",NA,1695,458,1237,1208,836,240,8,113,1,10,29,2072,614,1458,1402,975,284,8,121,1,13,56,"-095.1446240","+29.5489886"
"1085","482013411011","48",NA,"1",NA,1092,441,651,601,405,131,1,64,0,0,50,1480,653,827,766,495,197,1,68,0,5,61,"-095.1349929","+29.5394197"
"1086","482013411021","48",NA,"1",NA,798,418,380,359,200,133,0,25,0,1,21,1038,575,463,430,229,170,0,25,0,6,33,"-095.1103460","+29.5462858"
"1087","482013411022","48",NA,"2",NA,1403,325,1078,1022,730,145,2,133,1,11,56,1603,390,1213,1145,800,178,2,153,1,11,68,"-095.1196881","+29.5466012"
"1088","482013412011","48",NA,"1",NA,1354,700,654,616,262,297,10,35,0,12,38,2046,1074,972,892,316,488,19,42,0,27,80,"-095.1143591","+29.5163784"
"1089","482013412012","48",NA,"2",NA,1406,276,1130,1093,833,118,0,130,0,12,37,1691,338,1353,1293,981,141,0,155,1,15,60,"-095.1030895","+29.5385501"
"1090","482013412013","48",NA,"3",NA,1277,274,1003,978,622,181,2,170,0,3,25,1589,372,1217,1178,735,231,2,207,0,3,39,"-095.1032877","+29.5301438"
"1091","482013412031","48",NA,"1",NA,734,127,607,566,448,87,1,20,2,8,41,851,162,689,641,490,120,1,20,2,8,48,"-095.0999364","+29.5406672"
"1092","482013412032","48",NA,"2",NA,1154,220,934,897,820,42,3,30,0,2,37,1504,330,1174,1109,1013,57,3,34,0,2,65,"-095.0956966","+29.5420040"
"1093","482013412041","48",NA,"1",NA,773,98,675,642,584,25,3,28,0,2,33,852,115,737,687,618,28,3,35,1,2,50,"-095.0770925","+29.5514925"
"1094","482013412042","48",NA,"2",NA,1152,294,858,818,639,135,6,32,0,6,40,1450,402,1048,997,765,183,6,37,0,6,51,"-095.0851383","+29.5464453"
"1095","482013412043","48",NA,"3",NA,1281,200,1081,1039,864,59,6,104,0,6,42,1541,260,1281,1225,1017,72,6,123,1,6,56,"-095.0897258","+29.5444325"
"1096","482013413021","48",NA,"1",NA,1263,272,991,941,626,149,0,155,0,11,50,1556,364,1192,1132,729,199,0,191,0,13,60,"-095.1072264","+29.5551492"
"1097","482013413022","48",NA,"2",NA,1429,432,997,952,543,278,0,121,3,7,45,1911,625,1286,1212,636,398,2,165,3,8,74,"-095.1015585","+29.5487731"
"1098","482013413031","48",NA,"1",NA,1374,181,1193,1139,1004,65,6,55,1,8,54,1523,234,1289,1221,1063,75,6,66,1,10,68,"-095.1076738","+29.5649425"
"1099","482013413032","48",NA,"2",NA,1462,406,1056,1000,649,170,6,161,0,14,56,1781,545,1236,1160,735,207,6,194,0,18,76,"-095.1119256","+29.5657347"
"1100","482013413041","48",NA,"1",NA,1074,126,948,912,752,76,3,80,0,1,36,1200,166,1034,990,803,85,3,98,0,1,44,"-095.0856818","+29.5667344"
"1101","482013413042","48",NA,"2",NA,682,114,568,552,261,85,4,201,0,1,16,836,170,666,650,305,108,7,229,0,1,16,"-095.1021918","+29.5772136"
"1102","482013414001","48",NA,"1",NA,1137,98,1039,1003,903,40,4,53,0,3,36,1430,142,1288,1233,1111,47,12,59,0,4,55,"-095.0524340","+29.5795410"
"1103","482013414002","48",NA,"2",NA,1650,186,1464,1407,1225,27,2,152,0,1,57,2065,261,1804,1713,1501,34,3,171,0,4,91,"-095.0695211","+29.5917747"
"1104","482013414003","48",NA,"3",NA,1756,251,1505,1437,1287,100,4,38,0,8,68,2169,318,1851,1741,1564,117,4,45,0,11,110,"-095.0630444","+29.5673770"
"1105","482013415011","48",NA,"1",NA,1242,190,1052,1006,889,95,0,21,0,1,46,1532,284,1248,1176,1040,108,0,27,0,1,72,"-095.0390227","+29.5738950"
"1106","482013415012","48",NA,"2",NA,1550,302,1248,1200,1088,74,8,16,0,14,48,1962,437,1525,1461,1321,86,9,21,0,24,64,"-095.0453741","+29.5679987"
"1107","482013415013","48",NA,"3",NA,1584,239,1345,1277,1124,54,3,87,0,9,68,2215,408,1807,1695,1497,75,4,109,0,10,112,"-095.0357889","+29.5856178"
"1108","482013415014","48",NA,"4",NA,805,63,742,712,653,9,8,33,1,8,30,1027,98,929,882,811,12,8,36,1,14,47,"-095.0437503","+29.5774752"
"1109","482013415021","48",NA,"1",NA,1050,171,879,808,670,64,9,48,4,13,71,1202,235,967,884,723,80,10,54,4,13,83,"-095.0375296","+29.5582023"
"1110","482013415022","48",NA,"2",NA,1126,114,1012,970,879,22,5,55,1,8,42,1454,164,1290,1224,1096,37,5,73,1,12,66,"-095.0306986","+29.5679927"
"1111","482013415023","48",NA,"3",NA,1391,244,1147,1099,916,128,0,45,0,10,48,1737,323,1414,1345,1112,167,0,55,0,11,69,"-095.0367628","+29.5671990"
"1112","482013416001","48",NA,"1",NA,1330,280,1050,1002,902,20,8,63,0,9,48,1713,405,1308,1242,1108,29,8,87,0,10,66,"-095.0184066","+29.5648384"
"1113","482013416002","48",NA,"2",NA,940,136,804,770,722,25,3,13,0,7,34,1225,204,1021,966,907,32,3,14,0,10,55,"-095.0105295","+29.5995792"
"1114","482013416003","48",NA,"3",NA,2368,340,2028,1927,1749,104,10,62,0,2,101,2971,477,2494,2345,2129,128,14,72,0,2,149,"-095.0133322","+29.5822450"
"1115","482013416004","48",NA,"4",NA,610,124,486,445,375,20,4,44,1,1,41,802,190,612,554,469,25,4,52,1,3,58,"-095.0223010","+29.5687264"
"1116","482013417001","48",NA,"1",NA,665,129,536,511,470,11,11,5,0,14,25,862,195,667,634,580,19,16,5,0,14,33,"-095.0135927","+29.6179285"
"1117","482013417002","48",NA,"2",NA,1503,277,1226,1180,1094,47,11,22,0,6,46,1861,402,1459,1404,1298,64,14,22,0,6,55,"-095.0147677","+29.6271989"
"1118","482013418001","48",NA,"1",NA,1062,236,826,806,735,51,5,13,0,2,20,1343,346,997,954,859,65,5,19,0,6,43,"-095.0278793","+29.6223544"
"1119","482013418002","48",NA,"2",NA,828,217,611,587,500,71,6,4,1,5,24,1146,319,827,767,650,94,6,10,1,6,60,"-095.0240275","+29.6434910"
"1120","482013420011","48",NA,"1",NA,2137,442,1695,1640,1536,21,11,61,1,10,55,2591,612,1979,1897,1772,23,11,75,1,15,82,"-095.1370566","+29.6375493"
"1121","482013420012","48",NA,"2",NA,1683,381,1302,1254,1088,21,2,128,4,11,48,2189,572,1617,1549,1357,23,2,152,4,11,68,"-095.1261843","+29.6406328"
"1122","482013420013","48",NA,"3",NA,1529,485,1044,1019,918,17,4,76,2,2,25,2032,723,1309,1277,1158,23,4,86,2,4,32,"-095.1383146","+29.6460824"
"1123","482013420021","48",NA,"1",NA,1546,628,918,889,632,84,5,167,1,0,29,2003,840,1163,1133,793,108,5,226,1,0,30,"-095.1529618","+29.6336430"
"1124","482013420022","48",NA,"2",NA,1967,676,1291,1245,1053,49,4,117,1,21,46,2433,944,1489,1442,1230,52,4,130,1,25,47,"-095.1502646","+29.6435795"
"1125","482013421001","48",NA,"1",NA,1495,915,580,554,504,29,0,21,0,0,26,2094,1359,735,688,599,49,0,39,1,0,47,"-095.1389482","+29.6602899"
"1126","482013421002","48",NA,"2",NA,1743,673,1070,1036,921,16,0,96,0,3,34,2198,950,1248,1197,1066,16,0,106,3,6,51,"-095.1460956","+29.6538146"
"1127","482013422001","48",NA,"1",NA,1735,864,871,811,738,56,5,12,0,0,60,2246,1231,1015,929,842,62,5,15,0,5,86,"-095.1483800","+29.6751967"
"1128","482013422002","48",NA,"2",NA,551,376,175,159,131,9,8,9,0,2,16,774,566,208,187,157,9,9,10,0,2,21,"-095.1483176","+29.6683131"
"1129","482013422003","48",NA,"3",NA,527,236,291,282,180,51,2,45,0,4,9,706,330,376,360,223,70,2,61,0,4,16,"-095.1363749","+29.6661752"
"1130","482013422004","48",NA,"4",NA,161,114,47,46,39,5,2,0,0,0,1,192,135,57,52,43,7,2,0,0,0,5,"-095.1391626","+29.6692501"
"1131","482013423001","48",NA,"1",NA,1477,625,852,812,765,31,1,13,0,2,40,2108,1004,1104,1045,975,42,1,20,0,7,59,"-095.1339248","+29.6788917"
"1132","482013423002","48",NA,"2",NA,1350,649,701,680,509,130,4,28,0,9,21,1935,1017,918,881,618,208,4,41,0,10,37,"-095.1329983","+29.6716765"
"1133","482013423003","48",NA,"3",NA,1232,711,521,495,454,11,3,24,0,3,26,1756,1104,652,610,560,13,3,30,0,4,42,"-095.1263021","+29.6717580"
"1134","482013423004","48",NA,"4",NA,949,511,438,419,330,72,4,2,0,11,19,1414,803,611,581,440,114,4,2,0,21,30,"-095.1270210","+29.6653734"
"1135","482013424001","48",NA,"1",NA,1016,643,373,345,318,17,3,7,0,0,28,1415,949,466,433,393,30,3,7,0,0,33,"-095.1502997","+29.7010156"
"1136","482013424002","48",NA,"2",NA,1828,1027,801,758,614,94,4,39,1,6,43,2592,1539,1053,983,779,149,4,44,1,6,70,"-095.1479112","+29.6848508"
"1137","482013425001","48",NA,"1",NA,1716,407,1309,1266,1216,12,9,26,0,3,43,2150,573,1577,1516,1456,14,9,33,0,4,61,"-095.1317655","+29.6973060"
"1138","482013425002","48",NA,"2",NA,967,375,592,565,528,19,3,11,0,4,27,1372,616,756,724,674,26,3,15,0,6,32,"-095.1342117","+29.7060816"
"1139","482013425003","48",NA,"3",NA,688,203,485,471,422,20,0,10,0,19,14,837,291,546,528,471,27,0,11,0,19,18,"-095.1269276","+29.6848910"
"1140","482013425004","48",NA,"4",NA,1515,372,1143,1101,1056,18,11,9,0,7,42,1881,554,1327,1280,1223,25,11,12,0,9,47,"-095.1366009","+29.6847607"
"1141","482013427001","48",NA,"1",NA,991,333,658,620,590,23,0,5,1,1,38,1354,517,837,777,723,44,0,8,1,1,60,"-095.1186590","+29.7081070"
"1142","482013427002","48",NA,"2",NA,1733,472,1261,1218,1163,24,7,14,0,10,43,2325,746,1579,1500,1437,28,8,17,0,10,79,"-095.1185511","+29.6947946"
"1143","482013427003","48",NA,"3",NA,1106,288,818,783,745,19,2,9,3,5,35,1466,449,1017,969,924,23,2,9,3,8,48,"-095.1182023","+29.6831031"
"1144","482013428011","48",NA,"1",NA,1747,613,1134,1079,957,34,6,65,1,16,55,2500,918,1582,1505,1368,35,9,74,1,18,77,"-095.0973438","+29.6848440"
"1145","482013428012","48",NA,"2",NA,1828,416,1412,1354,1305,13,7,18,7,4,58,2367,638,1729,1647,1581,25,10,20,7,4,82,"-095.1067731","+29.6849346"
"1146","482013428021","48",NA,"1",NA,1381,323,1058,1002,954,8,8,24,0,8,56,1882,500,1382,1310,1247,9,10,33,0,11,72,"-095.0979034","+29.6904494"
"1147","482013428022","48",NA,"2",NA,1616,373,1243,1197,1145,9,4,36,0,3,46,2106,569,1537,1484,1411,15,5,40,0,13,53,"-095.1030580","+29.7030496"
"1148","482013429001","48",NA,"1",NA,768,262,506,482,460,4,4,14,0,0,24,953,360,593,563,538,7,4,14,0,0,30,"-095.1183420","+29.6668693"
"1149","482013429002","48",NA,"2",NA,1994,495,1499,1441,1378,29,3,21,3,7,58,2494,746,1748,1661,1592,33,3,22,4,7,87,"-095.1206915","+29.6755368"
"1150","482013429003","48",NA,"3",NA,2644,864,1780,1678,1573,44,12,37,5,7,102,3637,1327,2310,2166,2021,70,12,45,5,13,144,"-095.1002263","+29.6718113"
"1151","482013430001","48",NA,"1",NA,1751,628,1123,1054,910,83,4,43,0,14,69,2356,953,1403,1311,1141,97,9,50,0,14,92,"-095.1198940","+29.6547108"
"1152","482013430002","48",NA,"2",NA,1859,838,1021,973,808,128,6,16,5,10,48,2613,1269,1344,1272,1002,218,6,21,5,20,72,"-095.1043657","+29.6562829"
"1153","482013430003","48",NA,"3",NA,1975,751,1224,1176,1060,72,1,43,0,0,48,2491,1040,1451,1381,1242,85,5,46,0,3,70,"-095.0927831","+29.6577675"
"1154","482013431001","48",NA,"1",NA,1433,414,1019,970,853,94,7,14,1,1,49,1907,621,1286,1225,1057,138,8,20,1,1,61,"-095.0813427","+29.6546703"
"1155","482013431002","48",NA,"2",NA,805,253,552,518,478,27,2,9,0,2,34,1074,381,693,655,598,35,5,15,0,2,38,"-095.0735400","+29.6595413"
"1156","482013431003","48",NA,"3",NA,1195,337,858,807,727,45,7,16,0,12,51,1575,493,1082,1021,927,55,7,19,0,13,61,"-095.0818481","+29.6607791"
"1157","482013432001","48",NA,"1",NA,2038,614,1424,1359,1257,77,0,16,0,9,65,2633,850,1783,1702,1579,93,0,17,0,13,81,"-095.0660553","+29.6602841"
"1158","482013432002","48",NA,"2",NA,1807,688,1119,1062,955,72,6,16,1,12,57,2456,1033,1423,1339,1208,95,6,17,1,12,84,"-095.0522907","+29.6574922"
"1159","482013433011","48",NA,"1",NA,1309,443,866,819,746,41,9,19,0,4,47,1736,641,1095,1029,933,54,9,26,0,7,66,"-095.0800152","+29.6771889"
"1160","482013433012","48",NA,"2",NA,1015,361,654,612,577,23,5,5,0,2,42,1348,561,787,724,683,29,5,5,0,2,63,"-095.0573799","+29.6884555"
"1161","482013433013","48",NA,"3",NA,1002,375,627,595,567,13,5,6,0,4,32,1316,543,773,737,703,18,5,6,0,5,36,"-095.0638432","+29.6817245"
"1162","482013433021","48",NA,"1",NA,2342,716,1626,1548,1393,103,5,30,5,12,78,2982,1015,1967,1855,1681,115,5,33,5,16,112,"-095.0618749","+29.6705855"
"1163","482013433022","48",NA,"2",NA,1446,433,1013,964,861,73,10,15,1,4,49,1894,619,1275,1204,1062,104,14,18,1,5,71,"-095.0828346","+29.6692444"
"1164","482013436011","48",NA,"1",NA,2,1,1,0,0,0,0,0,0,0,1,11,4,7,0,0,0,0,0,0,0,7,"-095.0709877","+29.7154848"
"1165","482013436021","48",NA,"1",NA,1129,345,784,755,671,59,3,17,0,5,29,1419,471,948,908,798,82,3,19,0,6,40,"-095.0018143","+29.6699927"
"1166","482013436022","48",NA,"2",NA,818,217,601,573,503,46,7,5,0,12,28,1041,312,729,692,601,63,9,5,0,14,37,"-095.0149281","+29.6548041"
"1167","482013436023","48",NA,"3",NA,658,287,371,353,305,35,1,8,0,4,18,881,413,468,444,382,43,6,8,0,5,24,"-095.0161123","+29.6633779"
"1168","482013437001","48",NA,"1",NA,906,379,527,495,259,226,0,4,0,6,32,1226,563,663,621,314,297,0,4,0,6,42,"-095.0298723","+29.6745167"
"1169","482013437002","48",NA,"2",NA,622,244,378,356,280,63,2,9,0,2,22,810,368,442,417,328,75,2,9,1,2,25,"-095.0243050","+29.6589486"
"1170","482013437003","48",NA,"3",NA,1490,578,912,861,674,149,3,28,0,7,51,1824,780,1044,982,763,180,3,28,1,7,62,"-095.0634646","+29.6243709"
"1171","482013501011","48",NA,"1",NA,1531,341,1190,1163,125,130,1,907,0,0,27,2191,500,1691,1647,177,171,1,1297,0,1,44,"-095.2085991","+29.5697166"
"1172","482013501012","48",NA,"2",NA,1420,459,961,942,203,248,1,490,0,0,19,1953,652,1301,1251,288,324,1,632,0,6,50,"-095.2202286","+29.5743933"
"1173","482013501013","48",NA,"3",NA,832,192,640,629,154,110,0,361,0,4,11,1125,289,836,806,190,136,1,473,0,6,30,"-095.2141076","+29.5802543"
"1174","482013501021","48",NA,"1",NA,2272,415,1857,1823,1168,174,5,459,0,17,34,2694,564,2130,2084,1238,218,5,604,2,17,46,"-095.2243874","+29.5637219"
"1175","482013501022","48",NA,"2",NA,1681,362,1319,1273,942,112,6,200,0,13,46,2136,529,1607,1546,1115,138,6,273,0,14,61,"-095.2366429","+29.5676829"
"1176","482013501031","48",NA,"1",NA,1579,724,855,833,334,213,14,267,0,5,22,2123,1048,1075,1043,398,292,14,328,0,11,32,"-095.2380716","+29.5769203"
"1177","482013501032","48",NA,"2",NA,1487,665,822,807,370,150,1,278,2,6,15,2019,1004,1015,989,422,195,1,362,2,7,26,"-095.2427123","+29.5818404"
"1178","482013501033","48",NA,"3",NA,2437,897,1540,1500,713,296,3,483,2,3,40,3345,1372,1973,1907,865,411,3,622,2,4,66,"-095.2501870","+29.5703291"
"1179","482013501041","48",NA,"1",NA,2383,875,1508,1471,479,280,0,702,0,10,37,3145,1257,1888,1820,562,364,2,878,0,14,68,"-095.2492388","+29.5879483"
"1180","482013501042","48",NA,"2",NA,1255,361,894,864,251,535,3,69,0,6,30,1705,507,1198,1155,272,791,6,76,0,10,43,"-095.2561430","+29.5942512"
"1181","482013502011","48",NA,"1",NA,1062,643,419,404,169,201,0,33,0,1,15,1561,999,562,547,216,284,0,39,0,8,15,"-095.2231016","+29.5978585"
"1182","482013502012","48",NA,"2",NA,1575,959,616,584,358,149,1,67,0,9,32,2179,1415,764,716,418,202,1,82,0,13,48,"-095.2287037","+29.5911437"
"1183","482013502021","48",NA,"1",NA,1908,1004,904,864,539,190,4,123,1,7,40,2499,1412,1087,1035,621,247,7,151,1,8,52,"-095.2357030","+29.5928672"
"1184","482013502022","48",NA,"2",NA,1723,945,778,741,357,176,5,195,0,8,37,2185,1293,892,846,401,220,7,207,0,11,46,"-095.2410411","+29.5979210"
"1185","482013503001","48",NA,"1",NA,1142,511,631,613,385,147,4,77,0,0,18,1457,728,729,704,430,180,5,88,0,1,25,"-095.2257710","+29.5854078"
"1186","482013503002","48",NA,"2",NA,1114,449,665,652,441,147,0,63,0,1,13,1464,648,816,784,513,184,1,82,1,3,32,"-095.2208979","+29.5834808"
"1187","482013503003","48",NA,"3",NA,1184,457,727,706,391,181,0,124,0,10,21,1474,631,843,807,444,207,1,144,0,11,36,"-095.2256535","+29.5780147"
"1188","482013503004","48",NA,"4",NA,1236,603,633,619,399,143,5,71,0,1,14,1607,846,761,735,463,182,5,84,0,1,26,"-095.2307957","+29.5824287"
"1189","482013504001","48",NA,"1",NA,1117,651,466,436,275,92,1,67,1,0,30,1521,933,588,551,322,130,1,95,1,2,37,"-095.2037436","+29.5999125"
"1190","482013504002","48",NA,"2",NA,1146,684,462,445,179,127,9,130,0,0,17,1592,1004,588,567,215,175,9,168,0,0,21,"-095.2118488","+29.5939375"
"1191","482013504003","48",NA,"3",NA,613,370,243,229,98,51,0,74,3,3,14,830,533,297,275,116,71,0,78,3,7,22,"-095.2124432","+29.5880229"
"1192","482013504004","48",NA,"4",NA,1629,736,893,861,223,475,1,154,4,4,32,2292,1074,1218,1175,277,702,1,180,4,11,43,"-095.2171029","+29.5912565"
"1193","482013505001","48",NA,"1",NA,927,313,614,602,219,126,0,249,2,6,12,1263,452,811,790,279,166,1,334,2,8,21,"-095.2007213","+29.5806245"
"1194","482013505002","48",NA,"2",NA,724,353,371,362,104,214,0,41,0,3,9,1017,518,499,480,126,305,0,46,0,3,19,"-095.1968461","+29.5951962"
"1195","482013505003","48",NA,"3",NA,1043,215,828,808,171,103,0,529,0,5,20,1444,311,1133,1098,207,144,2,735,0,10,35,"-095.1926702","+29.5736240"
"1196","482013505004","48",NA,"4",NA,1562,1024,538,524,220,145,1,152,0,6,14,2112,1471,641,620,260,172,1,177,0,10,21,"-095.1992146","+29.5904004"
"1197","482013505005","48",NA,"5",NA,977,620,357,348,191,72,0,81,0,4,9,1281,842,439,424,225,94,1,97,0,7,15,"-095.1940801","+29.5866567"
"1198","482013506011","48",NA,"1",NA,1856,468,1388,1323,974,244,5,96,1,3,65,2311,651,1660,1581,1132,301,9,129,1,9,79,"-095.1747074","+29.5573909"
"1199","482013506012","48",NA,"2",NA,1604,403,1201,1159,840,167,7,131,2,12,42,2061,583,1478,1411,1036,201,10,147,2,15,67,"-095.1738190","+29.5446587"
"1200","482013506031","48",NA,"1",NA,1668,425,1243,1198,775,178,4,232,1,8,45,2242,619,1623,1532,999,230,4,287,1,11,91,"-095.1679714","+29.5322080"
"1201","482013506032","48",NA,"2",NA,1762,383,1379,1323,811,166,3,319,11,13,56,2389,578,1811,1727,1071,233,4,393,11,15,84,"-095.1751261","+29.5369449"
"1202","482013506041","48",NA,"1",NA,764,202,562,542,403,80,0,55,0,4,20,999,278,721,686,497,115,0,68,2,4,35,"-095.1897970","+29.5448465"
"1203","482013506042","48",NA,"2",NA,937,181,756,723,475,78,5,153,0,12,33,1269,293,976,925,610,101,10,190,1,13,51,"-095.1800906","+29.5360608"
"1204","482013506043","48",NA,"3",NA,1274,292,982,925,667,148,0,106,1,3,57,1673,413,1260,1160,843,188,4,118,3,4,100,"-095.1852420","+29.5438312"
"1205","482013507001","48",NA,"1",NA,1165,257,908,863,784,58,1,20,0,0,45,1579,402,1177,1109,990,93,1,23,0,2,68,"-095.1826823","+29.5294645"
"1206","482013507002","48",NA,"2",NA,601,155,446,430,407,10,1,10,2,0,16,747,214,533,515,485,14,1,12,2,1,18,"-095.1903870","+29.5393295"
"1207","482013508011","48",NA,"1",NA,1117,324,793,755,630,75,2,45,2,1,38,1487,460,1027,966,799,106,3,53,2,3,61,"-095.1756889","+29.5273782"
"1208","482013508012","48",NA,"2",NA,858,237,621,578,494,55,4,21,2,2,43,1196,360,836,770,662,72,4,21,2,9,66,"-095.1796609","+29.5219392"
"1209","482013508013","48",NA,"3",NA,886,228,658,635,511,77,1,41,5,0,23,1152,321,831,790,622,102,1,55,5,5,41,"-095.1701410","+29.5233857"
"1210","482013508014","48",NA,"4",NA,918,324,594,582,325,179,5,63,3,7,12,1263,468,795,763,418,238,8,86,3,10,32,"-095.1647005","+29.5256804"
"1211","482013508031","48",NA,"1",NA,711,207,504,465,256,153,0,54,2,0,39,874,271,603,561,308,182,5,64,2,0,42,"-095.1612033","+29.5241800"
"1212","482013508032","48",NA,"2",NA,806,257,549,535,366,132,0,30,0,7,14,1016,363,653,626,432,157,0,30,0,7,27,"-095.1595201","+29.5284076"
"1213","482013508033","48",NA,"3",NA,983,257,726,682,535,98,3,43,0,3,44,1291,381,910,853,669,128,4,48,1,3,57,"-095.1496325","+29.5299023"
"1214","482013508041","48",NA,"1",NA,1710,271,1439,1392,720,140,0,520,3,9,47,2355,427,1928,1867,960,191,0,703,3,10,61,"-095.1669060","+29.5075702"
"1215","482013508042","48",NA,"2",NA,1456,168,1288,1255,889,102,2,261,1,0,33,1865,255,1610,1551,1089,135,2,324,1,0,59,"-095.1562330","+29.5118903"
"1216","482013508043","48",NA,"3",NA,172,15,157,146,119,18,0,9,0,0,11,213,21,192,179,146,20,0,13,0,0,13,"-095.1440295","+29.5093245"
"1217","482013508044","48",NA,"4",NA,990,165,825,797,514,132,1,146,0,4,28,1215,199,1016,950,586,181,1,177,0,5,66,"-095.1364528","+29.5174409"
"1218","482014101011","48",NA,"1",NA,735,144,591,564,373,108,2,74,0,7,27,837,175,662,620,395,139,2,77,0,7,42,"-095.3837472","+29.7543444"
"1219","482014101012","48",NA,"2",NA,1071,285,786,734,359,264,2,100,0,9,52,1322,358,964,902,382,400,2,109,0,9,62,"-095.3807719","+29.7553833"
"1220","482014101021","48",NA,"1",NA,1532,190,1342,1304,517,620,1,156,1,9,38,1914,203,1711,1663,527,961,1,159,1,14,48,"-095.3808281","+29.7600224"
"1221","482014101022","48",NA,"2",NA,1986,410,1576,1495,1095,217,1,166,2,14,81,2093,438,1655,1547,1117,232,1,175,2,20,108,"-095.3766562","+29.7550608"
"1222","482014102011","48",NA,"1",NA,2060,365,1695,1607,1305,99,0,192,0,11,88,2176,396,1780,1686,1355,112,1,204,0,14,94,"-095.3910167","+29.7589404"
"1223","482014102021","48",NA,"1",NA,986,192,794,757,612,38,1,97,2,7,37,1074,214,860,815,653,43,1,109,2,7,45,"-095.3905458","+29.7550442"
"1224","482014102022","48",NA,"2",NA,1320,215,1105,1059,842,51,7,147,0,12,46,1467,262,1205,1137,900,55,7,160,3,12,68,"-095.3951170","+29.7549357"
"1225","482014102023","48",NA,"3",NA,756,127,629,604,506,5,7,83,1,2,25,820,142,678,652,550,5,7,86,2,2,26,"-095.3873079","+29.7550988"
"1226","482014103001","48",NA,"1",NA,994,155,839,804,632,64,2,104,0,2,35,1062,168,894,857,667,67,2,119,0,2,37,"-095.4001710","+29.7552045"
"1227","482014103002","48",NA,"2",NA,1117,188,929,899,745,34,0,109,0,11,30,1183,214,969,935,771,36,0,117,0,11,34,"-095.4000976","+29.7590487"
"1228","482014103003","48",NA,"3",NA,1371,154,1217,1168,1038,44,0,79,1,6,49,1477,177,1300,1234,1082,54,0,91,1,6,66,"-095.4054053","+29.7556533"
"1229","482014104011","48",NA,"1",NA,920,123,797,777,689,16,4,66,0,2,20,1040,139,901,863,758,16,4,76,0,9,38,"-095.4084964","+29.7454152"
"1230","482014104012","48",NA,"2",NA,931,172,759,715,595,23,4,91,1,1,44,1054,200,854,792,649,29,4,107,1,2,62,"-095.4042038","+29.7454776"
"1231","482014104013","48",NA,"3",NA,617,52,565,541,479,7,0,51,0,4,24,687,69,618,585,498,7,0,76,0,4,33,"-095.4085025","+29.7506909"
"1232","482014104014","48",NA,"4",NA,1022,176,846,808,698,25,2,82,0,1,38,1204,219,985,928,801,25,2,90,0,10,57,"-095.4050879","+29.7499729"
"1233","482014104021","48",NA,"1",NA,920,124,796,764,650,23,0,82,1,8,32,1036,151,885,841,707,27,0,98,1,8,44,"-095.3985811","+29.7498233"
"1234","482014104022","48",NA,"2",NA,629,108,521,504,418,8,0,75,1,2,17,744,136,608,579,488,10,1,77,1,2,29,"-095.4002166","+29.7451152"
"1235","482014104023","48",NA,"3",NA,752,115,637,615,519,33,0,54,2,7,22,843,130,713,681,562,38,0,71,3,7,32,"-095.3974201","+29.7463420"
"1236","482014105011","48",NA,"1",NA,1535,276,1259,1207,1031,41,2,125,1,7,52,1746,335,1411,1324,1124,51,2,137,1,9,87,"-095.3923612","+29.7491032"
"1237","482014105021","48",NA,"1",NA,974,149,825,795,689,33,1,62,0,10,30,1130,194,936,889,767,37,1,73,0,11,47,"-095.3873155","+29.7490606"
"1238","482014105022","48",NA,"2",NA,818,137,681,654,514,46,2,84,0,8,27,846,144,702,673,526,47,2,89,0,9,29,"-095.3820013","+29.7507092"
"1239","482014105023","48",NA,"3",NA,994,210,784,744,550,33,1,130,30,0,40,1094,253,841,797,589,36,1,137,30,4,44,"-095.3842548","+29.7480491"
"1240","482014106011","48",NA,"1",NA,3331,626,2705,2577,1752,359,6,422,0,38,128,3444,682,2762,2629,1786,370,6,429,0,38,133,"-095.3777657","+29.7445300"
"1241","482014106021","48",NA,"1",NA,738,134,604,589,409,86,6,67,18,3,15,835,141,694,677,417,94,6,70,87,3,17,"-095.3745339","+29.7506528"
"1242","482014106022","48",NA,"2",NA,1587,328,1259,1180,934,115,1,114,2,14,79,1673,355,1318,1231,967,123,1,117,9,14,87,"-095.3799110","+29.7486135"
"1243","482014107031","48",NA,"1",NA,1215,179,1036,994,785,73,2,132,0,2,42,1288,197,1091,1041,816,84,2,137,0,2,50,"-095.3918103","+29.7416730"
"1244","482014107032","48",NA,"2",NA,807,118,689,659,575,18,3,62,0,1,30,891,134,757,712,623,23,3,62,0,1,45,"-095.3969608","+29.7409077"
"1245","482014107041","48",NA,"1",NA,1021,165,856,823,688,75,0,60,0,0,33,1073,171,902,864,720,76,2,65,0,1,38,"-095.3860373","+29.7403505"
"1246","482014107042","48",NA,"2",NA,759,130,629,602,519,31,0,52,0,0,27,822,135,687,650,560,34,1,54,0,1,37,"-095.3850382","+29.7434564"
"1247","482014107051","48",NA,"1",NA,57,11,46,42,38,1,0,2,0,1,4,66,15,51,47,43,1,0,2,0,1,4,"-095.3972720","+29.7356223"
"1248","482014107052","48",NA,"2",NA,798,234,564,532,408,46,1,77,0,0,32,850,255,595,554,430,46,1,77,0,0,41,"-095.3931453","+29.7368891"
"1249","482014107061","48",NA,"1",NA,1648,267,1381,1311,835,322,5,136,0,13,70,1738,304,1434,1353,866,324,5,145,0,13,81,"-095.3850116","+29.7361984"
"1250","482014108011","48",NA,"1",NA,909,197,712,667,500,42,0,112,0,13,45,1047,257,790,722,528,44,1,136,0,13,68,"-095.4084593","+29.7364202"
"1251","482014108012","48",NA,"2",NA,1361,218,1143,1099,885,61,3,147,0,3,44,1531,255,1276,1210,967,68,3,169,0,3,66,"-095.4027861","+29.7364925"
"1252","482014108021","48",NA,"1",NA,919,180,739,707,644,15,0,48,0,0,32,1100,245,855,795,723,18,1,51,0,2,60,"-095.4031830","+29.7407034"
"1253","482014108022","48",NA,"2",NA,485,99,386,373,274,39,0,56,0,4,13,531,115,416,400,287,47,0,61,0,5,16,"-095.4088581","+29.7406428"
"1254","482014109001","48",NA,"1",NA,1702,282,1420,1351,1093,80,0,173,1,4,69,1989,350,1639,1530,1242,89,0,194,1,4,109,"-095.4057346","+29.7330410"
"1255","482014109002","48",NA,"2",NA,1401,215,1186,1136,864,93,2,167,2,8,50,1546,259,1287,1222,923,98,2,186,2,11,65,"-095.3933459","+29.7331824"
"1256","482014110011","48",NA,"1",NA,1150,146,1004,976,709,94,0,156,0,17,28,1223,160,1063,1027,741,105,0,164,0,17,36,"-095.4207569","+29.7411572"
"1257","482014110012","48",NA,"2",NA,710,74,636,603,548,29,0,25,0,1,33,763,88,675,637,576,32,0,28,0,1,38,"-095.4252866","+29.7400562"
"1258","482014110021","48",NA,"1",NA,814,115,699,673,497,42,0,133,0,1,26,931,137,794,755,546,43,0,165,0,1,39,"-095.4126405","+29.7408250"
"1259","482014110022","48",NA,"2",NA,1164,157,1007,964,804,35,1,115,0,9,43,1255,179,1076,1018,845,36,1,127,0,9,58,"-095.4163909","+29.7402337"
"1260","482014110031","48",NA,"1",NA,1436,217,1219,1180,924,71,6,168,0,11,39,1614,253,1361,1289,1004,79,6,188,0,12,72,"-095.4146908","+29.7346933"
"1261","482014111001","48",NA,"1",NA,945,71,874,855,777,6,0,70,0,2,19,1259,106,1153,1124,1013,10,1,98,0,2,29,"-095.4136177","+29.7537218"
"1262","482014111002","48",NA,"2",NA,849,107,742,719,573,34,0,106,0,6,23,1024,129,895,858,639,45,1,167,0,6,37,"-095.4146946","+29.7478008"
"1263","482014111003","48",NA,"3",NA,905,164,741,718,583,35,0,98,0,2,23,1137,196,941,892,691,48,2,146,0,5,49,"-095.4147083","+29.7446041"
"1264","482014112001","48",NA,"1",NA,838,67,771,757,685,12,0,55,1,4,14,1056,99,957,933,827,21,0,80,1,4,24,"-095.4372174","+29.7546633"
"1265","482014112002","48",NA,"2",NA,558,37,521,519,502,0,0,15,0,2,2,703,48,655,644,616,0,0,23,3,2,11,"-095.4273387","+29.7505278"
"1266","482014113011","48",NA,"1",NA,1983,352,1631,1569,1188,178,5,189,0,9,62,2119,394,1725,1637,1226,197,5,200,0,9,88,"-095.4529919","+29.7530335"
"1267","482014113021","48",NA,"1",NA,1008,209,799,766,538,98,0,123,1,6,33,1112,242,870,830,577,109,0,133,1,10,40,"-095.4551705","+29.7441776"
"1268","482014113022","48",NA,"2",NA,1976,265,1711,1627,1188,190,2,213,0,34,84,2105,284,1821,1726,1244,215,2,228,0,37,95,"-095.4506635","+29.7437557"
"1269","482014114001","48",NA,"1",NA,989,54,935,922,854,14,0,54,0,0,13,1242,95,1147,1120,1021,15,1,79,0,4,27,"-095.4420197","+29.7442597"
"1270","482014114002","48",NA,"2",NA,606,49,557,544,506,7,0,30,0,1,13,797,67,730,699,639,8,3,48,0,1,31,"-095.4313090","+29.7447576"
"1271","482014114003","48",NA,"3",NA,523,30,493,490,466,5,0,19,0,0,3,735,61,674,661,616,6,2,35,0,2,13,"-095.4226049","+29.7450510"
"1272","482014115031","48",NA,"1",NA,1594,280,1314,1256,884,91,1,273,0,7,58,1763,340,1423,1356,936,107,2,301,0,10,67,"-095.4238184","+29.7323084"
"1273","482014115032","48",NA,"2",NA,1481,230,1251,1192,943,79,0,161,0,9,59,1715,284,1431,1351,1058,90,0,193,0,10,80,"-095.4242431","+29.7362301"
"1274","482014115041","48",NA,"1",NA,824,134,690,656,474,87,5,88,0,2,34,904,160,744,699,500,95,5,97,0,2,45,"-095.4323856","+29.7378704"
"1275","482014115042","48",NA,"2",NA,1333,225,1108,1047,756,89,0,202,0,0,61,1425,253,1172,1098,800,94,0,204,0,0,74,"-095.4335312","+29.7328676"
"1276","482014115051","48",NA,"1",NA,1550,224,1326,1255,983,72,0,193,0,7,71,1754,254,1500,1405,1097,79,0,221,0,8,95,"-095.4447621","+29.7388936"
"1277","482014115052","48",NA,"2",NA,903,140,763,702,508,68,0,118,1,7,61,1072,179,893,822,591,84,0,137,1,9,71,"-095.4447139","+29.7328324"
"1278","482014115061","48",NA,"1",NA,1217,203,1014,969,638,133,0,193,0,5,45,1305,222,1083,1036,676,141,0,214,0,5,47,"-095.4400324","+29.7354402"
"1279","482014115062","48",NA,"2",NA,921,97,824,804,642,36,2,119,0,5,20,968,116,852,824,653,40,2,124,0,5,28,"-095.4389332","+29.7308882"
"1280","482014115071","48",NA,"1",NA,1887,377,1510,1458,1065,150,0,239,1,3,52,2093,442,1651,1579,1121,182,0,269,1,6,72,"-095.4385028","+29.7381671"
"1281","482014116001","48",NA,"1",NA,1100,90,1010,991,917,22,0,47,0,5,19,1290,111,1179,1140,1053,28,0,54,0,5,39,"-095.4508504","+29.7362440"
"1282","482014116002","48",NA,"2",NA,1373,188,1185,1133,806,139,0,187,0,1,52,1643,231,1412,1346,950,157,0,238,0,1,66,"-095.4563685","+29.7347780"
"1283","482014117001","48",NA,"1",NA,769,217,552,524,369,84,0,68,3,0,28,823,252,571,542,380,87,0,72,3,0,29,"-095.4542009","+29.7283962"
"1284","482014117002","48",NA,"2",NA,800,162,638,609,355,118,0,130,0,6,29,905,193,712,675,381,130,0,155,0,9,37,"-095.4530670","+29.7214632"
"1285","482014117003","48",NA,"3",NA,1818,273,1545,1462,786,222,5,435,1,13,83,2065,315,1750,1658,841,244,6,551,1,15,92,"-095.4547030","+29.7237975"
"1286","482014118011","48",NA,"1",NA,1107,127,980,944,654,80,0,209,1,0,36,1390,172,1218,1154,773,98,0,281,1,1,64,"-095.4331284","+29.7264077"
"1287","482014118012","48",NA,"2",NA,1492,221,1271,1228,828,67,0,325,3,5,43,1867,273,1594,1512,964,73,1,460,3,11,82,"-095.4408514","+29.7264469"
"1288","482014118021","48",NA,"1",NA,1019,123,896,858,649,38,3,166,0,2,38,1243,160,1083,1018,772,43,3,196,0,4,65,"-095.4145688","+29.7281917"
"1289","482014118022","48",NA,"2",NA,1383,212,1171,1116,810,89,0,202,0,15,55,1515,253,1262,1186,834,102,0,230,3,17,76,"-095.4228916","+29.7281854"
"1290","482014119011","48",NA,"1",NA,587,86,501,485,434,12,4,33,1,1,16,676,100,576,551,490,13,4,42,1,1,25,"-095.3953288","+29.7299533"
"1291","482014119012","48",NA,"2",NA,1109,101,1008,969,886,21,0,55,0,7,39,1403,159,1244,1177,1070,30,0,70,0,7,67,"-095.4049666","+29.7284060"
"1292","482014119021","48",NA,"1",NA,1982,242,1740,1693,1340,144,0,205,0,4,47,2135,278,1857,1791,1413,148,3,220,0,7,66,"-095.3929645","+29.7266021"
"1293","482014120001","48",NA,"1",NA,961,58,903,879,770,8,1,97,0,3,24,1177,77,1100,1059,918,15,1,120,0,5,41,"-095.4043492","+29.7230906"
"1294","482014120002","48",NA,"2",NA,1504,159,1345,1310,1092,29,5,175,0,9,35,1726,197,1529,1467,1221,34,5,194,1,12,62,"-095.4156147","+29.7203003"
"1295","482014120003","48",NA,"3",NA,667,34,633,608,562,10,0,35,0,1,25,841,50,791,761,707,12,0,40,0,2,30,"-095.4105590","+29.7216458"
"1296","482014122011","48",NA,"1",NA,588,63,525,514,279,23,0,210,0,2,11,712,71,641,623,327,29,0,264,0,3,18,"-095.4092809","+29.7049988"
"1297","482014122012","48",NA,"2",NA,756,64,692,668,566,21,1,72,0,8,24,988,105,883,833,702,28,2,93,0,8,50,"-095.4077526","+29.7118940"
"1298","482014122013","48",NA,"3",NA,950,101,849,813,507,63,1,239,0,3,36,1182,131,1051,985,625,77,2,278,0,3,66,"-095.4083281","+29.7082414"
"1299","482014122021","48",NA,"1",NA,673,75,598,560,440,40,0,74,0,6,38,892,115,777,713,552,45,0,105,0,11,64,"-095.4118873","+29.7016007"
"1300","482014122022","48",NA,"2",NA,750,66,684,659,427,13,1,216,0,2,25,1033,86,947,898,572,23,1,296,0,6,49,"-095.4154528","+29.7073366"
"1301","482014122023","48",NA,"3",NA,957,86,871,822,541,21,4,242,0,14,49,1168,114,1054,972,659,31,4,261,0,17,82,"-095.4155070","+29.7126615"
"1302","482014123001","48",NA,"1",NA,975,94,881,847,680,8,0,158,0,1,34,1352,131,1221,1154,912,14,0,223,0,5,67,"-095.4203617","+29.7201214"
"1303","482014123002","48",NA,"2",NA,937,62,875,849,719,16,0,114,0,0,26,1284,88,1196,1151,961,25,0,165,0,0,45,"-095.4207213","+29.7106084"
"1304","482014123003","48",NA,"3",NA,1073,93,980,956,796,0,11,149,0,0,24,1442,147,1295,1228,1035,1,12,179,0,1,67,"-095.4264742","+29.7105383"
"1305","482014123004","48",NA,"4",NA,977,57,920,894,777,6,0,111,0,0,26,1367,104,1263,1207,1036,11,0,157,0,3,56,"-095.4261453","+29.7175647"
"1306","482014123005","48",NA,"5",NA,989,100,889,860,759,7,0,89,0,5,29,1392,155,1237,1168,1006,10,0,142,0,10,69,"-095.4260989","+29.7227396"
"1307","482014124001","48",NA,"1",NA,490,33,457,449,418,2,0,28,1,0,8,666,52,614,591,552,4,0,34,1,0,23,"-095.4319531","+29.7212809"
"1308","482014124002","48",NA,"2",NA,977,66,911,893,789,3,2,99,0,0,18,1340,97,1243,1190,1040,4,3,139,0,4,53,"-095.4370598","+29.7203487"
"1309","482014124003","48",NA,"3",NA,712,41,671,644,554,8,0,78,1,3,27,1055,77,978,907,775,10,2,115,1,4,71,"-095.4315585","+29.7116401"
"1310","482014124004","48",NA,"4",NA,960,102,858,831,664,3,2,151,1,10,27,1442,159,1283,1220,978,6,2,220,1,13,63,"-095.4386235","+29.7128667"
"1311","482014125001","48",NA,"1",NA,1411,150,1261,1203,948,60,0,192,0,3,58,1835,201,1634,1534,1230,63,0,238,0,3,100,"-095.4354835","+29.7086859"
"1312","482014126001","48",NA,"1",NA,901,103,798,761,629,8,0,122,0,2,37,1333,165,1168,1093,900,16,0,173,0,4,75,"-095.4445203","+29.7096732"
"1313","482014126002","48",NA,"2",NA,1117,109,1008,976,773,11,3,184,0,5,32,1598,177,1421,1347,1060,15,3,260,0,9,74,"-095.4447745","+29.7204166"
"1314","482014126003","48",NA,"3",NA,643,55,588,571,479,4,1,86,0,1,17,954,96,858,810,672,7,1,123,0,7,48,"-095.4445143","+29.7149696"
"1315","482014127001","48",NA,"1",NA,952,113,839,806,546,13,1,245,0,1,33,1253,161,1092,1029,676,17,2,330,0,4,63,"-095.4544008","+29.7176118"
"1316","482014127002","48",NA,"2",NA,1615,183,1432,1398,998,46,1,346,0,7,34,2117,279,1838,1774,1198,60,3,500,0,13,64,"-095.4531036","+29.7103428"
"1317","482014128001","48",NA,"1",NA,1390,112,1278,1242,905,13,2,314,4,4,36,1978,169,1809,1719,1215,28,2,462,4,8,90,"-095.4533825","+29.7022973"
"1318","482014128002","48",NA,"2",NA,1024,102,922,899,601,4,5,287,0,2,23,1521,160,1361,1308,862,6,5,428,0,7,53,"-095.4532338","+29.6963210"
"1319","482014128003","48",NA,"3",NA,948,88,860,836,505,9,4,316,0,2,24,1406,139,1267,1213,718,9,6,477,0,3,54,"-095.4531968","+29.6926897"
"1320","482014129011","48",NA,"1",NA,1332,229,1103,1060,483,384,0,190,0,3,43,1577,291,1286,1232,564,428,0,237,0,3,54,"-095.4529350","+29.6850348"
"1321","482014129021","48",NA,"1",NA,797,94,703,684,361,116,0,205,2,0,19,980,128,852,806,415,138,0,251,2,0,46,"-095.4431237","+29.6824556"
"1322","482014129022","48",NA,"2",NA,1862,274,1588,1564,909,292,1,354,3,5,24,2146,356,1790,1748,978,380,2,380,3,5,42,"-095.4480278","+29.6827483"
"1323","482014130001","48",NA,"1",NA,1178,105,1073,1034,819,30,1,175,0,9,39,1695,177,1518,1436,1137,43,1,240,0,15,82,"-095.4422597","+29.6965848"
"1324","482014130002","48",NA,"2",NA,662,108,554,538,362,76,0,99,0,1,16,753,130,623,607,404,83,0,116,0,4,16,"-095.4381100","+29.6921771"
"1325","482014130003","48",NA,"3",NA,720,111,609,593,363,46,1,178,2,3,16,1059,175,884,836,501,67,1,259,2,6,48,"-095.4392275","+29.6998327"
"1326","482014131001","48",NA,"1",NA,818,93,725,703,541,30,0,128,0,4,22,1133,136,997,958,737,38,0,175,1,7,39,"-095.4296224","+29.7007396"
"1327","482014131002","48",NA,"2",NA,642,68,574,554,484,14,4,50,0,2,20,948,132,816,758,659,16,4,77,0,2,58,"-095.4324890","+29.6967492"
"1328","482014131003","48",NA,"3",NA,678,75,603,576,482,8,2,80,0,4,27,1007,126,881,843,698,15,2,124,0,4,38,"-095.4355501","+29.6984641"
"1329","482014132031","48",NA,"1",NA,1354,209,1145,1136,710,92,1,333,0,0,9,1547,240,1307,1278,775,102,1,400,0,0,29,"-095.4257110","+29.7032683"
"1330","482014132041","48",NA,"1",NA,921,186,735,708,282,185,0,237,1,3,27,1077,214,863,832,329,210,2,287,1,3,31,"-095.4246003","+29.6991945"
"1331","482014132051","48",NA,"1",NA,1293,237,1056,1009,590,105,5,305,0,4,47,1458,272,1186,1128,635,123,5,359,0,6,58,"-095.4205660","+29.7031646"
"1332","482014132061","48",NA,"1",NA,1377,213,1164,1116,624,116,0,364,3,9,48,1575,249,1326,1258,688,132,1,423,3,11,68,"-095.4163528","+29.6990392"
"1333","482014132062","48",NA,"2",NA,1050,145,905,877,425,118,0,329,2,3,28,1238,177,1061,1019,490,134,0,390,2,3,42,"-095.4211792","+29.6986314"
"1334","482014133011","48",NA,"1",NA,771,111,660,624,326,133,2,155,1,7,36,922,156,766,716,386,149,3,167,1,10,50,"-095.4216821","+29.6916012"
"1335","482014133012","48",NA,"2",NA,1053,140,913,899,283,399,0,209,0,8,14,1260,165,1095,1077,310,501,0,256,0,10,18,"-095.4246295","+29.6844892"
"1336","482014133013","48",NA,"3",NA,718,99,619,593,485,8,4,93,2,1,26,946,129,817,765,615,15,4,125,2,4,52,"-095.4249403","+29.6914314"
"1337","482014133014","48",NA,"4",NA,1265,212,1053,1031,458,195,0,371,0,7,22,1361,234,1127,1099,496,196,0,400,0,7,28,"-095.4154858","+29.6948264"
"1338","482014133021","48",NA,"1",NA,1033,160,873,853,572,51,2,223,5,0,20,1348,222,1126,1086,707,68,2,303,5,1,40,"-095.4295515","+29.6857925"
"1339","482014133022","48",NA,"2",NA,712,109,603,571,391,49,4,119,0,8,32,914,162,752,705,498,62,4,130,0,11,47,"-095.4353774","+29.6878248"
"1340","482014133023","48",NA,"3",NA,754,88,666,630,468,33,3,123,0,3,36,947,119,828,770,573,37,3,145,0,12,58,"-095.4358726","+29.6823163"
"1341","482014201001","48",NA,"1",NA,696,130,566,559,58,479,0,20,0,2,7,893,178,715,708,61,617,0,25,0,5,7,"-095.4371673","+29.6689993"
"1342","482014201002","48",NA,"2",NA,1082,337,745,718,221,279,4,210,0,4,27,1381,477,904,855,255,334,7,250,0,9,49,"-095.4356507","+29.6777596"
"1343","482014201003","48",NA,"3",NA,421,138,283,262,85,154,0,23,0,0,21,499,181,318,293,95,162,0,35,0,1,25,"-095.4345339","+29.6747933"
"1344","482014202001","48",NA,"1",NA,1130,392,738,708,408,155,0,141,0,4,30,1397,510,887,850,464,221,0,159,0,6,37,"-095.4427158","+29.6654049"
"1345","482014202002","48",NA,"2",NA,787,329,458,429,179,142,1,107,0,0,29,1033,462,571,527,201,195,1,129,0,1,44,"-095.4433348","+29.6763861"
"1346","482014203001","48",NA,"1",NA,853,110,743,714,612,41,0,57,0,4,29,1064,166,898,853,725,49,0,75,0,4,45,"-095.4510470","+29.6684554"
"1347","482014203002","48",NA,"2",NA,890,180,710,675,402,212,2,45,0,14,35,1122,230,892,847,510,263,2,54,0,18,45,"-095.4512781","+29.6758999"
"1348","482014203003","48",NA,"3",NA,1120,146,974,929,592,232,1,97,1,6,45,1371,194,1177,1116,716,272,2,119,1,6,61,"-095.4566046","+29.6722785"
"1349","482014204001","48",NA,"1",NA,885,167,718,686,593,25,1,66,0,1,32,1102,227,875,832,721,33,5,72,0,1,43,"-095.4601883","+29.6606393"
"1350","482014204002","48",NA,"2",NA,1227,176,1051,1004,867,44,0,89,0,4,47,1529,257,1272,1188,1031,49,0,103,0,5,84,"-095.4525588","+29.6599834"
"1351","482014204003","48",NA,"3",NA,683,248,435,420,319,59,0,39,0,3,15,856,336,520,500,393,62,0,42,0,3,20,"-095.4557189","+29.6544987"
"1352","482014205001","48",NA,"1",NA,545,421,124,120,48,55,0,17,0,0,4,755,604,151,143,52,68,0,21,0,2,8,"-095.4778698","+29.6446991"
"1353","482014205002","48",NA,"2",NA,991,677,314,303,87,128,6,77,0,5,11,1472,1052,420,404,114,185,10,90,0,5,16,"-095.4722713","+29.6488511"
"1354","482014205003","48",NA,"3",NA,1147,769,378,370,51,197,1,121,0,0,8,1618,1165,453,444,57,255,2,130,0,0,9,"-095.4693180","+29.6534761"
"1355","482014206001","48",NA,"1",NA,1680,390,1290,1242,930,147,0,150,4,11,48,2279,634,1645,1549,1158,183,0,191,4,13,96,"-095.4701300","+29.6611026"
"1356","482014207001","48",NA,"1",NA,1210,127,1083,1028,851,34,4,135,0,4,55,1684,199,1485,1384,1143,45,4,188,0,4,101,"-095.4718851","+29.6683491"
"1357","482014207002","48",NA,"2",NA,923,103,820,796,601,46,0,131,1,17,24,1355,153,1202,1147,874,59,2,187,1,24,55,"-095.4657349","+29.6760943"
"1358","482014208001","48",NA,"1",NA,476,74,402,389,275,17,0,94,0,3,13,611,106,505,480,345,23,0,107,0,5,25,"-095.4626182","+29.6845257"
"1359","482014208002","48",NA,"2",NA,616,63,553,533,380,7,0,140,0,6,20,827,82,745,712,513,10,0,183,0,6,33,"-095.4697879","+29.6830151"
"1360","482014208003","48",NA,"3",NA,598,47,551,523,404,8,0,108,2,1,28,836,85,751,705,523,18,1,160,2,1,46,"-095.4747652","+29.6844817"
"1361","482014209001","48",NA,"1",NA,641,51,590,566,413,3,0,144,0,6,24,913,91,822,768,547,8,0,204,0,9,54,"-095.4673272","+29.7032263"
"1362","482014209002","48",NA,"2",NA,1470,124,1346,1305,1010,21,0,271,0,3,41,2042,166,1876,1796,1369,32,0,388,0,7,80,"-095.4658677","+29.6994680"
"1363","482014209003","48",NA,"3",NA,1151,94,1057,1017,776,13,0,224,0,4,40,1577,151,1426,1349,1018,13,0,310,0,8,77,"-095.4749070","+29.6966847"
"1364","482014209004","48",NA,"4",NA,1371,110,1261,1236,878,33,1,315,0,9,25,1854,159,1695,1641,1145,51,1,434,0,10,54,"-095.4710764","+29.6925305"
"1365","482014210001","48",NA,"1",NA,781,97,684,662,447,31,6,168,5,5,22,1071,147,924,866,576,45,6,225,5,9,58,"-095.4635952","+29.7183765"
"1366","482014210002","48",NA,"2",NA,1158,148,1010,977,714,18,3,236,0,6,33,1496,212,1284,1223,871,20,3,317,0,12,61,"-095.4669054","+29.7091122"
"1367","482014211011","48",NA,"1",NA,769,232,537,514,239,183,0,92,0,0,23,894,283,611,584,268,216,0,99,0,1,27,"-095.4685709","+29.7230041"
"1368","482014211012","48",NA,"2",NA,1464,538,926,899,236,362,3,295,0,3,27,1801,712,1089,1057,269,405,4,372,0,7,32,"-095.4752554","+29.7233439"
"1369","482014211013","48",NA,"3",NA,381,210,171,155,25,125,0,5,0,0,16,562,328,234,211,31,170,0,6,0,4,23,"-095.4743613","+29.7193029"
"1370","482014211031","48",NA,"1",NA,1114,234,880,866,101,595,3,158,0,9,14,1473,320,1153,1120,119,798,3,189,0,11,33,"-095.4806352","+29.7182901"
"1371","482014211041","48",NA,"1",NA,1070,968,102,97,32,59,1,1,0,4,5,1695,1543,152,143,52,82,2,1,0,6,9,"-095.4784227","+29.7211686"
"1372","482014211042","48",NA,"2",NA,1117,1042,75,74,15,58,0,0,0,1,1,1678,1560,118,115,34,73,0,0,0,8,3,"-095.4826946","+29.7221440"
"1373","482014211043","48",NA,"3",NA,646,477,169,155,42,95,0,13,0,5,14,1003,778,225,205,49,135,0,13,0,8,20,"-095.4796830","+29.7243611"
"1374","482014212031","48",NA,"1",NA,719,387,332,327,73,193,3,58,0,0,5,935,532,403,392,88,227,6,71,0,0,11,"-095.4882043","+29.7228333"
"1375","482014212032","48",NA,"2",NA,662,377,285,265,51,145,1,63,0,5,20,870,526,344,314,58,166,2,80,0,8,30,"-095.4868964","+29.7241951"
"1376","482014212041","48",NA,"1",NA,543,253,290,284,67,176,0,36,0,5,6,686,354,332,324,73,202,0,39,1,9,8,"-095.4910978","+29.7220532"
"1377","482014212042","48",NA,"2",NA,1155,954,201,190,31,153,0,5,0,1,11,1742,1464,278,264,42,205,1,8,0,8,14,"-095.4879047","+29.7208414"
"1378","482014212051","48",NA,"1",NA,1533,1248,285,270,55,177,8,24,1,5,15,2315,1879,436,409,101,255,10,31,1,11,27,"-095.4937154","+29.7180990"
"1379","482014212061","48",NA,"1",NA,1348,1212,136,116,43,55,6,5,0,7,20,2054,1847,207,178,68,84,6,11,0,9,29,"-095.4869012","+29.7182163"
"1380","482014213011","48",NA,"1",NA,1254,998,256,250,51,151,3,42,0,3,6,1650,1320,330,314,61,192,3,53,0,5,16,"-095.4941339","+29.7072508"
"1381","482014213012","48",NA,"2",NA,1326,923,403,384,53,294,3,34,0,0,19,1926,1332,594,569,71,447,3,45,0,3,25,"-095.4953958","+29.7093539"
"1382","482014213021","48",NA,"1",NA,1635,236,1399,1375,228,322,8,811,0,6,24,2659,369,2290,2234,302,500,8,1412,1,11,56,"-095.5035855","+29.7094600"
"1383","482014213022","48",NA,"2",NA,1221,442,779,765,190,220,1,339,0,15,14,1764,634,1130,1110,245,335,1,503,0,26,20,"-095.4988036","+29.7081632"
"1384","482014214011","48",NA,"1",NA,1024,766,258,248,30,147,8,39,2,22,10,1450,1109,341,320,36,192,8,52,2,30,21,"-095.4907040","+29.7140533"
"1385","482014214012","48",NA,"2",NA,1313,569,744,685,66,226,1,387,5,0,59,2067,842,1225,1133,86,334,1,703,5,4,92,"-095.4935966","+29.7146772"
"1386","482014214021","48",NA,"1",NA,1160,1008,152,148,16,96,0,29,0,7,4,1721,1508,213,200,24,121,0,41,0,14,13,"-095.4868725","+29.7155447"
"1387","482014214022","48",NA,"2",NA,1079,838,241,214,9,134,0,68,0,3,27,1563,1225,338,302,23,163,0,110,0,6,36,"-095.4868408","+29.7137480"
"1388","482014214031","48",NA,"1",NA,901,758,143,140,10,118,3,6,0,3,3,1314,1068,246,242,14,205,3,8,0,12,4,"-095.4895661","+29.7070086"
"1389","482014214032","48",NA,"2",NA,901,639,262,253,19,178,0,56,0,0,9,1370,939,431,420,29,305,0,84,0,2,11,"-095.4920452","+29.7103814"
"1390","482014214033","48",NA,"3",NA,1314,1044,270,256,110,101,2,43,0,0,14,1913,1542,371,342,126,151,2,58,0,5,29,"-095.4878628","+29.7104029"
"1391","482014215011","48",NA,"1",NA,881,480,401,383,117,208,1,55,0,2,18,1271,724,547,520,131,294,3,89,0,3,27,"-095.4797747","+29.7071019"
"1392","482014215012","48",NA,"2",NA,1097,565,532,509,263,163,2,71,0,10,23,1420,773,647,622,304,214,2,89,0,13,25,"-095.4731093","+29.7128977"
"1393","482014215013","48",NA,"3",NA,561,476,85,83,20,26,2,28,0,7,2,837,714,123,121,27,39,2,37,0,16,2,"-095.4825899","+29.7082783"
"1394","482014215021","48",NA,"1",NA,694,321,373,355,67,218,2,62,0,6,18,906,432,474,447,68,298,2,72,0,7,27,"-095.4785161","+29.7128292"
"1395","482014215022","48",NA,"2",NA,688,137,551,545,37,420,1,87,0,0,6,907,174,733,724,44,586,1,93,0,0,9,"-095.4831861","+29.7155133"
"1396","482014215023","48",NA,"3",NA,749,136,613,606,65,416,1,124,0,0,7,1025,170,855,845,71,625,1,147,0,1,10,"-095.4831600","+29.7136929"
"1397","482014216011","48",NA,"1",NA,1170,1031,139,127,37,63,0,22,0,5,12,1830,1637,193,180,53,89,0,24,0,14,13,"-095.4909582","+29.7006906"
"1398","482014216012","48",NA,"2",NA,807,687,120,111,16,87,0,8,0,0,9,1282,1092,190,174,27,127,0,14,0,6,16,"-095.4877436","+29.7015350"
"1399","482014216021","48",NA,"1",NA,545,373,172,167,47,21,0,99,0,0,5,785,540,245,236,77,26,0,133,0,0,9,"-095.4840927","+29.7041868"
"1400","482014216022","48",NA,"2",NA,1121,631,490,475,277,37,2,157,0,2,15,1611,919,692,649,372,66,2,199,1,9,43,"-095.4774386","+29.7017486"
"1401","482014216023","48",NA,"3",NA,656,589,67,52,18,23,1,8,0,2,15,1013,918,95,70,23,26,1,12,1,7,25,"-095.4836545","+29.7014033"
"1402","482014217001","48",NA,"1",NA,1114,697,417,409,196,100,0,113,0,0,8,1570,1037,533,514,236,139,1,138,0,0,19,"-095.4872082","+29.6952155"
"1403","482014217002","48",NA,"2",NA,748,242,506,481,344,32,1,98,2,4,25,930,320,610,571,398,34,5,121,2,11,39,"-095.4893280","+29.6912704"
"1404","482014217003","48",NA,"3",NA,923,104,819,793,562,21,0,198,0,12,26,1184,150,1034,989,691,28,0,257,1,12,45,"-095.4907757","+29.6824032"
"1405","482014217004","48",NA,"4",NA,719,94,625,612,474,36,4,92,0,6,13,910,142,768,751,584,41,4,116,0,6,17,"-095.4853981","+29.6823922"
"1406","482014218011","48",NA,"1",NA,948,248,700,655,182,426,3,38,0,6,45,1258,337,921,865,220,574,5,56,0,10,56,"-095.4781675","+29.6804056"
"1407","482014218012","48",NA,"2",NA,1319,394,925,883,221,596,0,60,1,5,42,1814,589,1225,1171,252,834,1,70,1,13,54,"-095.4799590","+29.6777533"
"1408","482014218021","48",NA,"1",NA,916,225,691,665,273,297,0,91,0,4,26,1206,289,917,869,340,399,0,125,0,5,48,"-095.4817753","+29.6812523"
"1409","482014218022","48",NA,"2",NA,1035,119,916,868,622,14,0,220,2,10,48,1261,145,1116,1049,743,23,0,263,3,17,67,"-095.4805156","+29.6873304"
"1410","482014219001","48",NA,"1",NA,702,78,624,601,521,33,0,39,0,8,23,963,121,842,796,689,42,0,57,0,8,46,"-095.4858339","+29.6739480"
"1411","482014219002","48",NA,"2",NA,833,85,748,724,652,26,1,43,0,2,24,1122,132,990,953,859,44,1,47,0,2,37,"-095.4815090","+29.6692673"
"1412","482014219003","48",NA,"3",NA,584,75,509,494,436,12,0,46,0,0,15,814,111,703,659,579,19,0,61,0,0,44,"-095.4892655","+29.6695636"
"1413","482014220001","48",NA,"1",NA,565,79,486,466,378,31,0,53,0,4,20,724,110,614,584,478,37,0,65,0,4,30,"-095.4866528","+29.6641664"
"1414","482014220002","48",NA,"2",NA,690,80,610,590,520,29,0,33,0,8,20,899,119,780,738,650,41,0,39,0,8,42,"-095.4880026","+29.6597830"
"1415","482014220003","48",NA,"3",NA,757,101,656,628,501,51,4,72,0,0,28,974,158,816,773,626,62,4,81,0,0,43,"-095.4797843","+29.6621111"
"1416","482014221001","48",NA,"1",NA,915,342,573,545,384,111,0,48,0,2,28,1208,534,674,633,446,135,0,50,0,2,41,"-095.4825370","+29.6545177"
"1417","482014221002","48",NA,"2",NA,713,338,375,358,206,108,2,37,0,5,17,935,478,457,426,240,138,2,39,0,7,31,"-095.4842388","+29.6458426"
"1418","482014221003","48",NA,"3",NA,938,524,414,398,210,150,4,34,0,0,16,1196,707,489,467,248,177,4,38,0,0,22,"-095.4891842","+29.6404517"
"1419","482014221004","48",NA,"4",NA,681,294,387,363,194,88,8,71,0,2,24,864,391,473,443,246,106,8,79,0,4,30,"-095.4899508","+29.6466094"
"1420","482014221005","48",NA,"5",NA,758,165,593,573,466,53,4,44,0,6,20,912,234,678,652,527,65,4,46,0,10,26,"-095.4892335","+29.6536156"
"1421","482014222001","48",NA,"1",NA,558,229,329,326,9,302,0,10,0,5,3,765,351,414,407,12,380,0,10,0,5,7,"-095.4988223","+29.6416680"
"1422","482014222002","48",NA,"2",NA,626,183,443,426,31,379,4,12,0,0,17,918,305,613,590,40,532,4,12,0,2,23,"-095.5053250","+29.6419046"
"1423","482014222003","48",NA,"3",NA,556,169,387,378,0,377,0,0,1,0,9,942,280,662,653,0,651,0,1,1,0,9,"-095.4951879","+29.6376391"
"1424","482014222004","48",NA,"4",NA,1130,319,811,792,25,746,1,16,0,4,19,1704,473,1231,1211,38,1150,1,18,0,4,20,"-095.4955739","+29.6417620"
"1425","482014222005","48",NA,"5",NA,1252,288,964,938,42,865,3,24,1,3,26,1695,451,1244,1208,46,1122,3,29,1,7,36,"-095.5042619","+29.6369930"
"1426","482014223021","48",NA,"1",NA,1789,539,1250,1191,310,782,0,90,2,7,59,2289,743,1546,1459,355,981,3,104,2,14,87,"-095.4971327","+29.6490268"
"1427","482014223031","48",NA,"1",NA,1047,455,592,567,27,493,6,32,0,9,25,1486,684,802,761,28,678,6,34,0,15,41,"-095.5052055","+29.6484660"
"1428","482014223032","48",NA,"2",NA,10,10,0,0,0,0,0,0,0,0,0,17,10,7,7,1,6,0,0,0,0,0,"-095.5070270","+29.6449386"
"1429","482014223033","48",NA,"3",NA,1474,226,1248,1226,47,1169,1,8,0,1,22,2047,343,1704,1674,47,1613,3,8,0,3,30,"-095.5068641","+29.6470093"
"1430","482014223041","48",NA,"1",NA,1349,660,689,662,48,575,0,31,0,8,27,1832,931,901,866,53,765,2,33,0,13,35,"-095.5018457","+29.6493757"
"1431","482014223042","48",NA,"2",NA,1227,763,464,451,22,331,0,86,0,12,13,1978,1244,734,718,30,531,0,139,0,18,16,"-095.5060231","+29.6533540"
"1432","482014224031","48",NA,"1",NA,1275,679,596,569,219,305,0,38,0,7,27,1792,1031,761,724,272,394,0,40,0,18,37,"-095.4989326","+29.6616183"
"1433","482014224032","48",NA,"2",NA,756,168,588,560,457,43,0,56,0,4,28,991,250,741,680,566,52,0,58,0,4,61,"-095.4944857","+29.6619278"
"1434","482014224041","48",NA,"1",NA,1020,638,382,366,205,97,5,42,1,16,16,1490,1022,468,436,226,135,5,45,1,24,32,"-095.4955654","+29.6548707"
"1435","482014224042","48",NA,"2",NA,912,840,72,70,16,44,0,10,0,0,2,1476,1356,120,113,42,57,0,10,0,4,7,"-095.5029519","+29.6553458"
"1436","482014224051","48",NA,"1",NA,341,65,276,270,8,258,0,4,0,0,6,389,87,302,295,9,282,0,4,0,0,7,"-095.5070190","+29.6580181"
"1437","482014224052","48",NA,"2",NA,964,228,736,723,123,344,0,255,0,1,13,1200,340,860,845,123,466,0,255,0,1,15,"-095.5070419","+29.6614929"
"1438","482014224061","48",NA,"1",NA,1126,613,513,485,139,316,0,27,0,3,28,1627,990,637,596,158,394,0,41,0,3,41,"-095.5025600","+29.6621998"
"1439","482014224062","48",NA,"2",NA,614,235,379,373,39,325,2,7,0,0,6,846,351,495,485,41,432,3,7,0,2,10,"-095.5054229","+29.6618182"
"1440","482014225011","48",NA,"1",NA,818,348,470,461,31,377,0,45,0,8,9,1212,509,703,688,40,550,0,72,0,26,15,"-095.5076062","+29.6737824"
"1441","482014225012","48",NA,"2",NA,619,422,197,193,32,145,0,13,0,3,4,1005,704,301,292,41,220,0,13,0,18,9,"-095.5041084","+29.6736327"
"1442","482014225013","48",NA,"3",NA,923,230,693,663,484,104,2,69,0,4,30,1164,335,829,784,559,125,3,88,0,9,45,"-095.4985286","+29.6755219"
"1443","482014225021","48",NA,"1",NA,929,153,776,744,644,30,7,58,0,5,32,1188,225,963,914,784,35,7,72,0,16,49,"-095.4972559","+29.6700821"
"1444","482014225022","48",NA,"2",NA,1421,797,624,618,91,517,0,6,0,4,6,2270,1297,973,967,119,816,0,10,0,22,6,"-095.5041957","+29.6684187"
"1445","482014226011","48",NA,"1",NA,1140,748,392,381,146,214,0,20,0,1,11,1728,1194,534,506,173,307,0,24,0,2,28,"-095.5074317","+29.6797132"
"1446","482014226012","48",NA,"2",NA,853,283,570,557,418,90,3,42,0,4,13,1085,397,688,662,478,131,3,44,0,6,26,"-095.5006004","+29.6803805"
"1447","482014226013","48",NA,"3",NA,1265,998,267,258,145,76,0,27,0,10,9,1794,1464,330,314,172,98,0,29,0,15,16,"-095.5060592","+29.6848977"
"1448","482014226021","48",NA,"1",NA,1112,444,668,643,522,71,0,42,0,8,25,1392,607,785,753,605,83,0,55,0,10,32,"-095.4961186","+29.6878602"
"1449","482014226022","48",NA,"2",NA,765,295,470,445,397,26,1,14,0,7,25,946,393,553,518,456,31,1,19,0,11,35,"-095.5012540","+29.6853320"
"1450","482014227011","48",NA,"1",NA,1232,827,405,400,114,247,4,33,0,2,5,1831,1267,564,552,127,368,4,51,0,2,12,"-095.5055252","+29.6907182"
"1451","482014227012","48",NA,"2",NA,981,719,262,253,146,18,0,84,0,5,9,1251,947,304,288,165,24,0,92,0,7,16,"-095.4979719","+29.7032027"
"1452","482014227013","48",NA,"3",NA,1520,1134,386,361,253,43,2,57,0,6,25,2025,1582,443,406,276,53,2,66,0,9,37,"-095.4989283","+29.6968469"
"1453","482014227021","48",NA,"1",NA,1419,895,524,501,330,60,2,100,0,9,23,1792,1169,623,590,374,79,2,124,0,11,33,"-095.5068472","+29.6979926"
"1454","482014227022","48",NA,"2",NA,1155,759,396,374,248,40,1,80,0,5,22,1465,998,467,438,280,59,1,90,0,8,29,"-095.5122346","+29.7001223"
"1455","482014228001","48",NA,"1",NA,1541,634,907,891,557,155,4,156,0,19,16,1847,854,993,964,573,187,4,178,0,22,29,"-095.5189085","+29.6916818"
"1456","482014228002","48",NA,"2",NA,582,302,280,273,128,91,0,52,0,2,7,733,407,326,318,142,117,0,54,0,5,8,"-095.5180143","+29.6843506"
"1457","482014228003","48",NA,"3",NA,1724,1323,401,389,95,232,2,37,0,23,12,2558,1966,592,568,120,364,2,48,2,32,24,"-095.5114830","+29.6884493"
"1458","482014229001","48",NA,"1",NA,448,421,27,25,5,20,0,0,0,0,2,730,684,46,43,12,20,0,0,0,11,3,"-095.5394958","+29.6769353"
"1459","482014229002","48",NA,"2",NA,638,533,105,105,21,41,0,12,0,31,0,936,778,158,156,27,45,0,14,0,70,2,"-095.5262986","+29.6801273"
"1460","482014229003","48",NA,"3",NA,1139,604,535,529,129,311,6,74,0,9,6,1467,797,670,658,151,409,6,76,0,16,12,"-095.5265850","+29.6870211"
"1461","482014229004","48",NA,"4",NA,1271,861,410,398,188,129,0,73,0,8,12,1741,1255,486,463,206,170,0,77,0,10,23,"-095.5328392","+29.6811780"
"1462","482014230011","48",NA,"1",NA,1892,1022,870,788,149,259,1,373,0,6,82,3019,1553,1466,1293,202,385,1,696,1,8,173,"-095.5093020","+29.6856750"
"1463","482014230021","48",NA,"1",NA,893,618,275,267,73,166,0,8,0,20,8,1231,878,353,344,90,206,0,17,0,31,9,"-095.5215429","+29.6760958"
"1464","482014230022","48",NA,"2",NA,1362,991,371,356,238,73,0,33,0,12,15,1841,1411,430,408,269,84,3,33,0,19,22,"-095.5142691","+29.6809182"
"1465","482014231001","48",NA,"1",NA,627,243,384,364,31,314,0,19,0,0,20,868,367,501,474,36,418,0,20,0,0,27,"-095.5494555","+29.6647245"
"1466","482014231002","48",NA,"2",NA,431,332,99,98,7,85,0,4,0,2,1,629,482,147,145,11,123,0,4,0,7,2,"-095.5321721","+29.6741245"
"1467","482014231003","48",NA,"3",NA,803,636,167,157,10,137,3,4,0,3,10,1278,1033,245,233,15,190,3,4,0,21,12,"-095.5342754","+29.6751523"
"1468","482014232011","48",NA,"1",NA,1270,657,613,597,280,236,0,77,0,4,16,1624,897,727,702,318,289,0,89,0,6,25,"-095.5457862","+29.6609524"
"1469","482014232012","48",NA,"2",NA,1233,617,616,608,248,293,1,64,0,2,8,1628,900,728,699,272,352,1,68,0,6,29,"-095.5389422","+29.6607248"
"1470","482014232031","48",NA,"1",NA,1062,431,631,619,148,448,0,16,0,7,12,1423,623,800,784,162,592,0,19,0,11,16,"-095.5328376","+29.6641542"
"1471","482014232032","48",NA,"2",NA,911,307,604,584,44,392,0,147,0,1,20,1144,409,735,709,51,488,1,167,0,2,26,"-095.5318895","+29.6594604"
"1472","482014232041","48",NA,"1",NA,1014,648,366,356,52,279,0,19,0,6,10,1490,1025,465,447,68,338,0,19,0,22,18,"-095.5301653","+29.6673813"
"1473","482014232042","48",NA,"2",NA,691,446,245,233,17,210,0,4,0,2,12,1015,665,350,326,29,285,0,4,0,8,24,"-095.5303930","+29.6704676"
"1474","482014232043","48",NA,"3",NA,1066,609,457,446,28,408,2,8,0,0,11,1557,933,624,613,29,573,2,9,0,0,11,"-095.5340210","+29.6687434"
"1475","482014233011","48",NA,"1",NA,1041,368,673,638,380,198,2,56,0,2,35,1334,540,794,737,417,252,3,56,0,9,57,"-095.5223520","+29.6690117"
"1476","482014233012","48",NA,"2",NA,1324,258,1066,1036,472,467,4,91,0,2,30,1684,350,1334,1283,546,610,4,115,0,8,51,"-095.5106085","+29.6696449"
"1477","482014233013","48",NA,"3",NA,1043,277,766,762,118,558,0,85,0,1,4,1375,386,989,982,142,742,1,93,0,4,7,"-095.5215324","+29.6668017"
"1478","482014233031","48",NA,"1",NA,751,106,645,636,131,487,0,17,0,1,9,818,135,683,674,141,511,0,17,0,5,9,"-095.5125877","+29.6582599"
"1479","482014233032","48",NA,"2",NA,705,108,597,569,70,466,6,19,0,8,28,991,178,813,780,115,621,7,23,0,14,33,"-095.5099177","+29.6612071"
"1480","482014233041","48",NA,"1",NA,1060,235,825,794,356,392,1,41,0,4,31,1317,305,1012,971,458,454,4,43,0,12,41,"-095.5165340","+29.6627345"
"1481","482014233042","48",NA,"2",NA,1003,170,833,822,47,630,0,141,0,4,11,1337,264,1073,1057,62,840,0,151,0,4,16,"-095.5244451","+29.6603730"
"1482","482014233043","48",NA,"3",NA,691,148,543,525,183,271,0,54,0,17,18,951,233,718,695,271,351,2,54,0,17,23,"-095.5173544","+29.6577769"
"1483","482014234011","48",NA,"1",NA,1267,237,1030,1009,366,597,3,32,1,10,21,1796,325,1471,1446,617,776,3,34,1,15,25,"-095.5125220","+29.6536805"
"1484","482014234012","48",NA,"2",NA,1071,199,872,845,243,450,1,138,0,13,27,1395,286,1109,1080,392,522,1,150,0,15,29,"-095.5199294","+29.6517846"
"1485","482014234013","48",NA,"3",NA,696,182,514,500,30,446,0,15,0,9,14,946,267,679,655,38,574,0,26,0,17,24,"-095.5130819","+29.6445846"
"1486","482014234014","48",NA,"4",NA,899,269,630,621,42,518,0,55,2,4,9,1192,414,778,760,52,641,0,61,2,4,18,"-095.5169645","+29.6459851"
"1487","482014234021","48",NA,"1",NA,2077,544,1533,1524,62,954,0,501,2,5,9,2583,735,1848,1820,71,1175,0,566,2,6,28,"-095.5318558","+29.6500997"
"1488","482014234022","48",NA,"2",NA,1063,224,839,812,55,689,0,57,1,10,27,1361,295,1066,1026,55,886,0,72,1,12,40,"-095.5248503","+29.6451871"
"1489","482014235001","48",NA,"1",NA,1628,430,1198,1167,497,409,0,252,0,9,31,1995,616,1379,1340,558,478,0,289,0,15,39,"-095.5411795","+29.6509447"
"1490","482014236001","48",NA,"1",NA,793,301,492,482,26,367,0,89,0,0,10,1112,470,642,626,32,499,0,93,0,2,16,"-095.5323572","+29.6416994"
"1491","482014236002","48",NA,"2",NA,1326,571,755,744,124,530,4,85,0,1,11,1723,811,912,897,137,642,6,104,0,8,15,"-095.5224886","+29.6352752"
"1492","482014236003","48",NA,"3",NA,1069,624,445,432,119,259,0,45,0,9,13,1400,865,535,520,129,333,1,47,0,10,15,"-095.5139454","+29.6335967"
"1493","482014236004","48",NA,"4",NA,2077,767,1310,1274,162,990,0,111,0,11,36,2708,1094,1614,1570,184,1223,0,145,0,18,44,"-095.5126144","+29.6393600"
"1494","482014301011","48",NA,"1",NA,773,126,647,623,530,33,0,56,0,4,24,880,165,715,679,578,35,0,62,0,4,36,"-095.4572600","+29.7772272"
"1495","482014301012","48",NA,"2",NA,1098,151,947,919,809,22,3,81,0,4,28,1274,198,1076,1036,903,29,3,97,0,4,40,"-095.4622158","+29.7806349"
"1496","482014301013","48",NA,"3",NA,733,229,504,490,288,119,3,72,0,8,14,836,260,576,555,323,129,3,91,0,9,21,"-095.4717386","+29.7817100"
"1497","482014301021","48",NA,"1",NA,1163,135,1028,1009,886,26,2,95,0,0,19,1365,183,1182,1150,988,32,2,125,0,3,32,"-095.4649000","+29.7717463"
"1498","482014301022","48",NA,"2",NA,1199,254,945,897,666,130,5,96,0,0,48,1482,288,1194,1135,840,160,5,124,0,6,59,"-095.4804612","+29.7814232"
"1499","482014302001","48",NA,"1",NA,1206,253,953,915,749,51,0,107,0,8,38,1518,325,1193,1132,924,59,0,139,0,10,61,"-095.4847472","+29.7759823"
"1500","482014303001","48",NA,"1",NA,823,47,776,750,673,10,0,62,0,5,26,1079,72,1007,969,876,10,0,74,0,9,38,"-095.4918046","+29.7689419"
"1501","482014303002","48",NA,"2",NA,1086,61,1025,997,858,14,2,119,0,4,28,1475,99,1376,1336,1163,14,4,151,0,4,40,"-095.5043220","+29.7707824"
"1502","482014303003","48",NA,"3",NA,1294,101,1193,1167,1065,10,0,90,0,2,26,1831,165,1666,1615,1469,13,3,125,0,5,51,"-095.4961554","+29.7783799"
"1503","482014304001","48",NA,"1",NA,1013,65,948,918,747,6,3,153,0,9,30,1317,84,1233,1186,985,6,3,182,0,10,47,"-095.5157902","+29.7680944"
"1504","482014304002","48",NA,"2",NA,1417,118,1299,1252,1029,19,1,202,0,1,47,1801,170,1631,1542,1274,24,1,235,0,8,89,"-095.5156239","+29.7525676"
"1505","482014305001","48",NA,"1",NA,723,71,652,619,480,17,9,108,0,5,33,1022,130,892,829,646,22,10,144,0,7,63,"-095.5265743","+29.7788851"
"1506","482014305002","48",NA,"2",NA,1021,146,875,853,702,12,1,135,0,3,22,1358,186,1172,1121,925,14,1,178,0,3,51,"-095.5135294","+29.7805764"
"1507","482014306001","48",NA,"1",NA,933,71,862,823,711,4,3,102,0,3,39,1283,124,1159,1095,948,9,3,131,0,4,64,"-095.5263159","+29.7673654"
"1508","482014306002","48",NA,"2",NA,1860,121,1739,1687,1345,3,2,337,0,0,52,2549,185,2364,2258,1793,14,2,448,0,1,106,"-095.5345332","+29.7634222"
"1509","482014307001","48",NA,"1",NA,646,52,594,580,347,17,1,215,0,0,14,877,80,797,776,473,17,1,285,0,0,21,"-095.5347881","+29.7759733"
"1510","482014307002","48",NA,"2",NA,822,46,776,720,606,3,4,105,0,2,56,1228,83,1145,1054,855,17,4,170,0,8,91,"-095.5422886","+29.7711427"
"1511","482014307003","48",NA,"3",NA,556,144,412,399,254,43,6,92,0,4,13,690,172,518,503,319,50,6,124,0,4,15,"-095.5401647","+29.7771727"
"1512","482014307004","48",NA,"4",NA,1240,101,1139,1135,834,59,1,241,0,0,4,1396,117,1279,1268,885,59,1,322,0,1,11,"-095.5380785","+29.7815702"
"1513","482014308001","48",NA,"1",NA,1125,99,1026,992,753,15,0,213,3,8,34,1550,140,1410,1341,1008,17,2,298,3,13,69,"-095.5551157","+29.7717435"
"1514","482014308002","48",NA,"2",NA,2175,270,1905,1813,1074,143,0,557,0,39,92,2637,330,2307,2185,1276,152,0,702,0,55,122,"-095.5563960","+29.7805379"
"1515","482014308003","48",NA,"3",NA,1311,114,1197,1163,874,2,0,280,0,7,34,1904,182,1722,1652,1241,2,0,393,0,16,70,"-095.5472584","+29.7750033"
"1516","482014309001","48",NA,"1",NA,1571,140,1431,1382,1218,21,0,132,0,11,49,1920,179,1741,1673,1453,24,0,180,0,16,68,"-095.5317095","+29.7523751"
"1517","482014309002","48",NA,"2",NA,535,31,504,492,420,0,1,70,0,1,12,741,62,679,649,547,0,1,100,0,1,30,"-095.5403149","+29.7559496"
"1518","482014309003","48",NA,"3",NA,1198,118,1080,1057,711,29,0,308,4,5,23,1560,167,1393,1341,840,40,0,447,4,10,52,"-095.5477360","+29.7603672"
"1519","482014309004","48",NA,"4",NA,1648,211,1437,1390,723,77,4,581,0,5,47,2185,294,1891,1819,918,100,4,792,0,5,72,"-095.5571974","+29.7645559"
"1520","482014310011","48",NA,"1",NA,1471,217,1254,1199,951,102,1,134,1,10,55,1868,284,1584,1508,1213,119,1,164,1,10,76,"-095.5458770","+29.7422921"
"1521","482014310012","48",NA,"2",NA,654,104,550,527,401,23,1,102,0,0,23,748,130,618,587,443,28,1,115,0,0,31,"-095.5555418","+29.7422006"
"1522","482014310021","48",NA,"1",NA,778,136,642,632,465,61,0,106,0,0,10,882,154,728,716,528,72,0,116,0,0,12,"-095.5559745","+29.7512421"
"1523","482014310022","48",NA,"2",NA,771,58,713,676,625,11,3,33,0,4,37,1009,100,909,849,784,15,3,40,0,7,60,"-095.5511688","+29.7573712"
"1524","482014310023","48",NA,"3",NA,834,74,760,731,640,15,0,75,0,1,29,1038,96,942,907,798,17,0,90,0,2,35,"-095.5472355","+29.7492997"
"1525","482014311011","48",NA,"1",NA,627,81,546,515,473,9,0,32,0,1,31,684,100,584,543,493,12,1,36,0,1,41,"-095.5355029","+29.7489785"
"1526","482014311012","48",NA,"2",NA,1148,228,920,854,580,152,2,116,0,4,66,1233,250,983,913,606,171,2,130,0,4,70,"-095.5366044","+29.7444590"
"1527","482014311013","48",NA,"3",NA,758,304,454,434,144,253,4,29,0,4,20,891,353,538,516,166,300,4,36,0,10,22,"-095.5331672","+29.7399924"
"1528","482014311014","48",NA,"4",NA,1076,262,814,792,356,350,2,83,0,1,22,1215,305,910,877,398,385,2,91,0,1,33,"-095.5358018","+29.7392454"
"1529","482014311021","48",NA,"1",NA,1401,259,1142,1121,684,238,3,189,1,6,21,1569,319,1250,1214,721,274,4,204,1,10,36,"-095.5256391","+29.7404720"
"1530","482014311022","48",NA,"2",NA,448,195,253,248,164,52,0,32,0,0,5,609,291,318,305,182,77,2,39,0,5,13,"-095.5303002","+29.7414782"
"1531","482014311023","48",NA,"3",NA,1410,442,968,928,419,441,2,58,0,8,40,1734,604,1130,1084,473,541,3,59,0,8,46,"-095.5329034","+29.7438247"
"1532","482014312031","48",NA,"1",NA,937,387,550,524,306,152,6,55,0,5,26,1237,512,725,690,404,198,11,72,0,5,35,"-095.5067310","+29.7397442"
"1533","482014312032","48",NA,"2",NA,745,265,480,454,171,137,3,137,2,4,26,880,322,558,528,192,145,3,181,2,5,30,"-095.5098521","+29.7424304"
"1534","482014312041","48",NA,"1",NA,1512,265,1247,1225,361,159,1,692,0,12,22,1894,300,1594,1570,403,194,2,959,0,12,24,"-095.5030097","+29.7405868"
"1535","482014312042","48",NA,"2",NA,1047,111,936,906,822,11,3,67,0,3,30,1291,154,1137,1099,985,16,12,80,0,6,38,"-095.5041270","+29.7473279"
"1536","482014312051","48",NA,"1",NA,1031,289,742,717,287,316,0,100,0,14,25,1194,344,850,822,323,374,0,111,0,14,28,"-095.5197625","+29.7391051"
"1537","482014312052","48",NA,"2",NA,736,218,518,474,182,251,1,40,0,0,44,1002,344,658,594,227,309,1,49,3,5,64,"-095.5164626","+29.7396292"
"1538","482014312053","48",NA,"3",NA,772,355,417,402,165,202,1,28,0,6,15,1011,475,536,512,213,259,1,32,0,7,24,"-095.5177855","+29.7394066"
"1539","482014312061","48",NA,"1",NA,641,182,459,454,111,157,1,175,0,10,5,801,211,590,580,138,190,1,240,0,11,10,"-095.5130357","+29.7389693"
"1540","482014312062","48",NA,"2",NA,1104,187,917,887,595,153,1,136,1,1,30,1184,214,970,925,607,164,1,151,1,1,45,"-095.5165927","+29.7418011"
"1541","482014313021","48",NA,"1",NA,1682,228,1454,1421,1161,138,2,114,0,6,33,2142,323,1819,1772,1457,167,2,136,0,10,47,"-095.4890386","+29.7460289"
"1542","482014313022","48",NA,"2",NA,1887,257,1630,1566,1273,138,2,131,0,22,64,2520,346,2174,2059,1723,147,3,162,0,24,115,"-095.4915280","+29.7419766"
"1543","482014313031","48",NA,"1",NA,960,252,708,661,343,212,4,101,0,1,47,1091,302,789,734,378,238,4,107,0,7,55,"-095.4986603","+29.7390844"
"1544","482014313032","48",NA,"2",NA,726,214,512,499,268,147,0,84,0,0,13,928,298,630,608,312,191,1,104,0,0,22,"-095.4990789","+29.7421480"
"1545","482014313041","48",NA,"1",NA,883,252,631,580,341,152,0,79,0,8,51,999,299,700,636,367,174,0,87,0,8,64,"-095.4993309","+29.7480837"
"1546","482014313042","48",NA,"2",NA,708,275,433,409,194,168,7,36,0,4,24,898,372,526,495,231,208,7,45,0,4,31,"-095.4963947","+29.7418871"
"1547","482014313043","48",NA,"3",NA,1155,256,899,850,590,108,2,137,0,13,49,1298,296,1002,945,641,126,2,160,0,16,57,"-095.4969968","+29.7485203"
"1548","482014314011","48",NA,"1",NA,724,140,584,564,383,108,0,62,2,9,20,797,158,639,609,414,117,0,67,2,9,30,"-095.4841992","+29.7479637"
"1549","482014314012","48",NA,"2",NA,1261,269,992,924,612,164,10,135,1,2,68,1473,337,1136,1051,681,189,10,168,1,2,85,"-095.4838531","+29.7421294"
"1550","482014314031","48",NA,"1",NA,614,125,489,472,279,54,8,126,0,5,17,753,144,609,591,328,72,8,174,0,9,18,"-095.4782290","+29.7404825"
"1551","482014314032","48",NA,"2",NA,665,102,563,550,412,39,0,92,0,7,13,751,127,624,604,444,48,0,103,0,9,20,"-095.4785519","+29.7470881"
"1552","482014314041","48",NA,"1",NA,715,107,608,582,439,36,1,95,2,9,26,815,138,677,640,474,36,1,118,2,9,37,"-095.4808795","+29.7402994"
"1553","482014314042","48",NA,"2",NA,1209,167,1042,989,663,117,1,199,0,9,53,1351,188,1163,1105,709,124,1,262,0,9,58,"-095.4811866","+29.7460901"
"1554","482014315031","48",NA,"1",NA,1396,175,1221,1177,826,122,4,218,0,7,44,1591,209,1382,1330,894,144,4,281,0,7,52,"-095.4981534","+29.7528951"
"1555","482014315041","48",NA,"1",NA,928,79,849,831,740,17,0,66,0,8,18,1022,102,920,896,802,17,0,66,0,11,24,"-095.4873362","+29.7541585"
"1556","482014315042","48",NA,"2",NA,963,65,898,867,800,16,3,44,0,4,31,1374,97,1277,1229,1144,17,3,59,0,6,48,"-095.4920628","+29.7536397"
"1557","482014315051","48",NA,"1",NA,647,65,582,560,487,25,4,44,0,0,22,702,87,615,588,498,33,4,53,0,0,27,"-095.4842905","+29.7518295"
"1558","482014315052","48",NA,"2",NA,803,96,707,679,598,21,2,53,0,5,28,901,107,794,756,651,27,4,69,0,5,38,"-095.4842282","+29.7564985"
"1559","482014315061","48",NA,"1",NA,1006,138,868,841,732,32,0,69,1,7,27,1078,160,918,886,760,34,0,82,1,9,32,"-095.4798413","+29.7597353"
"1560","482014315062","48",NA,"2",NA,1569,268,1301,1235,910,112,2,202,0,9,66,1744,304,1440,1356,963,123,2,257,0,11,84,"-095.4799604","+29.7534204"
"1561","482014316001","48",NA,"1",NA,886,39,847,820,774,8,7,31,0,0,27,1058,75,983,953,886,15,7,44,0,1,30,"-095.4732403","+29.7675790"
"1562","482014316002","48",NA,"2",NA,979,107,872,845,782,24,3,29,0,7,27,1176,128,1048,1017,946,24,3,37,0,7,31,"-095.4831937","+29.7632893"
"1563","482014316003","48",NA,"3",NA,1106,91,1015,989,942,15,0,28,0,4,26,1259,111,1148,1120,1065,17,0,33,0,5,28,"-095.4895193","+29.7637306"
"1564","482014317011","48",NA,"1",NA,890,127,763,734,575,83,0,74,0,2,29,983,153,830,793,616,96,2,77,0,2,37,"-095.4653726","+29.7641943"
"1565","482014317012","48",NA,"2",NA,1405,159,1246,1212,1043,75,2,87,0,5,34,1490,171,1319,1282,1094,89,2,91,1,5,37,"-095.4618371","+29.7584522"
"1566","482014317021","48",NA,"1",NA,1319,133,1186,1161,1056,20,1,84,0,0,25,1568,176,1392,1343,1214,20,1,106,0,2,49,"-095.4705984","+29.7533913"
"1567","482014317022","48",NA,"2",NA,1105,112,993,981,925,11,3,41,0,1,12,1279,151,1128,1111,1034,16,3,54,0,4,17,"-095.4703775","+29.7595859"
"1568","482014318011","48",NA,"1",NA,1278,119,1159,1109,829,104,2,173,0,1,50,1445,150,1295,1232,914,113,3,201,0,1,63,"-095.4686963","+29.7447893"
"1569","482014318012","48",NA,"2",NA,987,163,824,810,611,86,0,109,0,4,14,1152,214,938,915,687,98,0,125,1,4,23,"-095.4745655","+29.7460323"
"1570","482014318013","48",NA,"3",NA,723,146,577,534,308,50,2,168,3,3,43,934,181,753,702,379,61,3,250,3,6,51,"-095.4738840","+29.7405076"
"1571","482014318031","48",NA,"1",NA,905,133,772,753,549,89,0,111,0,4,19,972,149,823,796,581,93,0,118,0,4,27,"-095.4651953","+29.7482700"
"1572","482014318032","48",NA,"2",NA,1431,328,1103,1029,604,218,1,196,1,9,74,1625,392,1233,1155,654,261,3,226,1,10,78,"-095.4656238","+29.7433050"
"1573","482014318041","48",NA,"1",NA,1007,231,776,757,481,107,0,146,0,23,19,1126,259,867,839,530,121,1,156,0,31,28,"-095.4592033","+29.7442627"
"1574","482014318042","48",NA,"2",NA,807,118,689,656,463,73,0,116,0,4,33,870,128,742,704,480,87,0,133,0,4,38,"-095.4579116","+29.7517648"
"1575","482014318043","48",NA,"3",NA,646,105,541,512,363,56,0,90,0,3,29,694,109,585,551,387,56,0,104,0,4,34,"-095.4593710","+29.7540650"
"1576","482014319011","48",NA,"1",NA,408,95,313,288,181,51,0,49,0,7,25,435,100,335,300,181,59,0,52,0,8,35,"-095.4652554","+29.7305866"
"1577","482014319012","48",NA,"2",NA,589,105,484,462,224,86,0,136,0,16,22,631,112,519,494,233,96,0,147,0,18,25,"-095.4629012","+29.7298462"
"1578","482014319013","48",NA,"3",NA,1201,198,1003,970,555,184,3,215,0,13,33,1324,237,1087,1050,595,208,3,229,0,15,37,"-095.4643974","+29.7287490"
"1579","482014319021","48",NA,"1",NA,1174,186,988,942,605,151,1,181,0,4,46,1270,207,1063,1002,633,159,1,203,0,6,61,"-095.4641335","+29.7381049"
"1580","482014319022","48",NA,"2",NA,1556,257,1299,1232,656,199,6,331,1,39,67,1693,286,1407,1337,692,214,6,385,1,39,70,"-095.4641122","+29.7335925"
"1581","482014320031","48",NA,"1",NA,834,305,529,504,238,194,0,60,0,12,25,966,363,603,568,259,225,0,67,0,17,35,"-095.4869170","+29.7334773"
"1582","482014320032","48",NA,"2",NA,890,354,536,515,253,185,0,50,0,27,21,1100,490,610,580,273,214,0,56,0,37,30,"-095.4871215","+29.7364278"
"1583","482014320041","48",NA,"1",NA,994,166,828,793,471,47,5,255,0,15,35,1293,224,1069,1006,569,72,5,340,2,18,63,"-095.4724047","+29.7347301"
"1584","482014320042","48",NA,"2",NA,777,137,640,629,415,81,2,128,1,2,11,980,183,797,769,481,96,2,185,3,2,28,"-095.4803762","+29.7346331"
"1585","482014320051","48",NA,"1",NA,884,338,546,516,196,234,0,73,1,12,30,1091,418,673,628,230,290,0,92,1,15,45,"-095.4926621","+29.7336436"
"1586","482014320052","48",NA,"2",NA,580,222,358,336,178,99,3,55,0,1,22,711,280,431,400,193,133,3,69,0,2,31,"-095.4919768","+29.7359305"
"1587","482014320053","48",NA,"3",NA,718,421,297,284,63,209,4,7,1,0,13,938,567,371,348,68,262,4,9,1,4,23,"-095.4941548","+29.7361298"
"1588","482014320061","48",NA,"1",NA,585,297,288,265,113,118,5,29,0,0,23,729,390,339,306,127,140,5,31,0,3,33,"-095.4986070","+29.7339405"
"1589","482014320062","48",NA,"2",NA,1041,672,369,365,93,252,0,15,0,5,4,1296,839,457,448,107,321,0,15,0,5,9,"-095.4973424","+29.7363898"
"1590","482014321011","48",NA,"1",NA,468,121,347,328,105,144,4,72,0,3,19,581,178,403,368,111,166,4,84,0,3,35,"-095.5193903","+29.7352965"
"1591","482014321012","48",NA,"2",NA,1869,811,1058,1003,377,333,3,280,1,9,55,2326,992,1334,1260,481,400,3,366,1,9,74,"-095.5158094","+29.7343018"
"1592","482014321021","48",NA,"1",NA,2335,833,1502,1441,452,622,7,351,1,8,61,2905,1053,1852,1778,575,717,11,459,1,15,74,"-095.5092029","+29.7345864"
"1593","482014321022","48",NA,"2",NA,572,87,485,467,418,5,3,41,0,0,18,799,120,679,653,593,7,4,48,0,1,26,"-095.5060907","+29.7324336"
"1594","482014322001","48",NA,"1",NA,846,163,683,650,513,50,1,76,0,10,33,1040,217,823,779,612,60,5,91,0,11,44,"-095.5357492","+29.7332050"
"1595","482014322002","48",NA,"2",NA,614,146,468,447,317,55,0,69,0,6,21,750,212,538,511,354,64,2,85,0,6,27,"-095.5292904","+29.7314861"
"1596","482014322003","48",NA,"3",NA,1455,538,917,882,406,312,0,157,0,7,35,1724,644,1080,1041,463,382,1,188,0,7,39,"-095.5283269","+29.7359774"
"1597","482014322004","48",NA,"4",NA,568,260,308,293,99,169,1,24,0,0,15,718,329,389,351,117,204,1,26,0,3,38,"-095.5229076","+29.7330664"
"1598","482014323011","48",NA,"1",NA,1373,622,751,724,224,398,2,88,0,12,27,1646,802,844,813,234,459,3,102,0,15,31,"-095.5413671","+29.7290374"
"1599","482014323012","48",NA,"2",NA,261,131,130,121,16,97,0,7,1,0,9,363,186,177,160,19,131,0,7,1,2,17,"-095.5415144","+29.7316075"
"1600","482014323013","48",NA,"3",NA,667,270,397,378,73,242,5,55,0,3,19,849,366,483,459,79,312,5,60,0,3,24,"-095.5412116","+29.7348953"
"1601","482014323021","48",NA,"1",NA,904,482,422,409,38,358,0,12,0,1,13,1278,644,634,614,49,547,0,15,0,3,20,"-095.5466038","+29.7313473"
"1602","482014323022","48",NA,"2",NA,778,254,524,490,96,357,1,29,2,5,34,963,326,637,592,107,442,1,35,2,5,45,"-095.5455721","+29.7296164"
"1603","482014323031","48",NA,"1",NA,1797,538,1259,1197,365,632,3,190,0,7,62,2221,688,1533,1455,421,793,5,226,0,10,78,"-095.5517775","+29.7330116"
"1604","482014324011","48",NA,"1",NA,1290,476,814,771,207,368,0,186,0,10,43,1564,616,948,897,225,456,1,203,0,12,51,"-095.5442195","+29.7211170"
"1605","482014324012","48",NA,"2",NA,976,343,633,604,251,231,4,99,0,19,29,1175,435,740,702,274,279,4,119,0,26,38,"-095.5425563","+29.7261806"
"1606","482014324013","48",NA,"3",NA,661,303,358,343,57,246,0,39,1,0,15,893,424,469,446,72,313,0,57,1,3,23,"-095.5416324","+29.7237236"
"1607","482014324021","48",NA,"1",NA,1095,514,581,568,103,419,2,37,0,7,13,1428,682,746,731,124,554,2,39,0,12,15,"-095.5462987","+29.7265466"
"1608","482014324022","48",NA,"2",NA,860,226,634,609,157,271,4,166,1,10,25,1054,314,740,706,170,325,4,193,1,13,34,"-095.5525191","+29.7235752"
"1609","482014325011","48",NA,"1",NA,698,299,399,339,119,108,0,112,0,0,60,1069,420,649,522,173,135,0,214,0,0,127,"-095.5313309","+29.7275927"
"1610","482014325012","48",NA,"2",NA,1355,580,775,715,343,247,4,118,1,2,60,1820,810,1010,923,420,323,6,169,1,4,87,"-095.5364120","+29.7244494"
"1611","482014325013","48",NA,"3",NA,717,309,408,402,157,155,0,85,0,5,6,912,411,501,489,176,209,0,96,0,8,12,"-095.5319625","+29.7228334"
"1612","482014325021","48",NA,"1",NA,638,334,304,277,98,137,2,35,0,5,27,886,481,405,367,109,186,2,62,0,8,38,"-095.5248062","+29.7275371"
"1613","482014325022","48",NA,"2",NA,697,359,338,333,175,120,1,37,0,0,5,879,475,404,392,202,148,1,41,0,0,12,"-095.5248593","+29.7234652"
"1614","482014326001","48",NA,"1",NA,542,51,491,481,438,10,1,27,2,3,10,744,85,659,637,581,17,2,31,2,4,22,"-095.5053954","+29.7282860"
"1615","482014326002","48",NA,"2",NA,866,280,586,563,212,302,0,47,0,2,23,1123,402,721,692,257,373,0,60,0,2,29,"-095.5125502","+29.7250792"
"1616","482014327031","48",NA,"1",NA,1717,432,1285,1218,811,210,3,190,0,4,67,2057,536,1521,1426,929,258,5,228,0,6,95,"-095.4723480","+29.7288262"
"1617","482014327041","48",NA,"1",NA,1263,824,439,417,222,133,2,57,0,3,22,1724,1167,557,512,266,164,2,67,0,13,45,"-095.4822382","+29.7288877"
"1618","482014327051","48",NA,"1",NA,1450,1292,158,153,57,84,0,12,0,0,5,2062,1852,210,204,75,111,1,12,0,5,6,"-095.4953977","+29.7247069"
"1619","482014327052","48",NA,"2",NA,821,758,63,55,14,34,0,3,0,4,8,1191,1113,78,70,19,39,1,7,0,4,8,"-095.4966198","+29.7269936"
"1620","482014327053","48",NA,"3",NA,758,714,44,40,24,9,1,6,0,0,4,1018,964,54,48,28,9,1,6,0,4,6,"-095.4994870","+29.7269462"
"1621","482014327061","48",NA,"1",NA,304,273,31,31,10,20,1,0,0,0,0,457,424,33,33,11,20,2,0,0,0,0,"-095.4982869","+29.7299232"
"1622","482014327062","48",NA,"2",NA,1125,641,484,459,285,113,4,45,0,12,25,1505,918,587,554,342,133,8,58,0,13,33,"-095.4916083","+29.7288081"
"1623","482014328031","48",NA,"1",NA,856,596,260,246,55,151,0,40,0,0,14,1235,905,330,312,73,180,0,51,0,8,18,"-095.5171456","+29.7142666"
"1624","482014328032","48",NA,"2",NA,813,563,250,246,85,107,1,46,0,7,4,1179,870,309,297,100,141,1,48,0,7,12,"-095.5184372","+29.7158372"
"1625","482014328033","48",NA,"3",NA,553,210,343,333,47,199,0,71,0,16,10,760,324,436,419,59,257,0,83,0,20,17,"-095.5146940","+29.7153841"
"1626","482014328041","48",NA,"1",NA,618,360,258,252,88,118,0,40,0,6,6,724,424,300,288,98,142,0,40,0,8,12,"-095.5119186","+29.7155957"
"1627","482014328042","48",NA,"2",NA,934,534,400,387,128,95,2,151,1,10,13,1231,701,530,510,153,129,2,214,1,11,20,"-095.5063371","+29.7185527"
"1628","482014328051","48",NA,"1",NA,741,570,171,157,21,112,1,19,0,4,14,1163,891,272,242,38,166,1,26,0,11,30,"-095.5189943","+29.7117881"
"1629","482014328052","48",NA,"2",NA,636,515,121,107,20,65,0,18,0,4,14,854,698,156,136,38,74,1,18,0,5,20,"-095.5168089","+29.7064996"
"1630","482014328061","48",NA,"1",NA,1268,777,491,482,237,157,6,77,0,5,9,1632,1084,548,532,247,182,10,83,0,10,16,"-095.5123152","+29.7107562"
"1631","482014328062","48",NA,"2",NA,979,664,315,303,57,113,0,130,0,3,12,1321,964,357,342,77,129,0,132,0,4,15,"-095.5092507","+29.7114843"
"1632","482014328063","48",NA,"3",NA,1050,608,442,430,101,226,1,100,1,1,12,1392,846,546,531,119,287,4,116,1,4,15,"-095.5168661","+29.7113843"
"1633","482014329011","48",NA,"1",NA,679,356,323,305,160,51,1,88,1,4,18,889,493,396,370,183,56,1,106,1,23,26,"-095.5226597","+29.7124471"
"1634","482014329012","48",NA,"2",NA,696,553,143,143,14,120,0,9,0,0,0,994,785,209,209,14,185,0,9,0,1,0,"-095.5316888","+29.7150529"
"1635","482014329013","48",NA,"3",NA,891,688,203,191,58,108,0,25,0,0,12,1278,1009,269,249,65,156,0,25,0,3,20,"-095.5298285","+29.7179177"
"1636","482014329031","48",NA,"1",NA,815,757,58,58,10,36,0,12,0,0,0,1171,1077,94,93,25,47,0,16,0,5,1,"-095.5379318","+29.7126746"
"1637","482014329032","48",NA,"2",NA,751,506,245,232,88,46,0,92,2,4,13,1025,708,317,295,97,63,2,103,2,28,22,"-095.5364363","+29.7093129"
"1638","482014329041","48",NA,"1",NA,828,652,176,171,32,81,0,56,0,2,5,1159,889,270,253,52,126,0,72,0,3,17,"-095.5283761","+29.7065179"
"1639","482014329042","48",NA,"2",NA,1149,303,846,825,229,142,2,445,0,7,21,1378,399,979,950,261,166,2,507,0,14,29,"-095.5306045","+29.7107157"
"1640","482014329043","48",NA,"3",NA,873,604,269,262,46,141,0,75,0,0,7,1260,862,398,381,66,231,0,83,0,1,17,"-095.5264478","+29.7073533"
"1641","482014330031","48",NA,"1",NA,1736,413,1323,1309,22,225,0,1052,0,10,14,2224,633,1591,1575,32,386,0,1146,1,10,16,"-095.5524974","+29.7080217"
"1642","482014330032","48",NA,"2",NA,842,561,281,279,29,78,0,129,0,43,2,1296,887,409,406,33,95,0,209,2,67,3,"-095.5472563","+29.7082648"
"1643","482014330033","48",NA,"3",NA,1485,1073,412,412,18,38,0,339,0,17,0,2060,1483,577,575,27,59,2,470,0,17,2,"-095.5471980","+29.7107778"
"1644","482014330041","48",NA,"1",NA,1238,922,316,314,57,140,1,115,0,1,2,1661,1292,369,367,62,166,1,131,0,7,2,"-095.5463748","+29.7181570"
"1645","482014330042","48",NA,"2",NA,1284,1195,89,84,4,54,0,26,0,0,5,1729,1608,121,116,12,70,0,34,0,0,5,"-095.5429841","+29.7163759"
"1646","482014330051","48",NA,"1",NA,875,307,568,552,29,92,0,431,0,0,16,1249,399,850,829,36,98,2,693,0,0,21,"-095.5525862","+29.7150681"
"1647","482014330052","48",NA,"2",NA,766,396,370,365,3,37,0,321,0,4,5,1160,508,652,635,8,53,0,569,0,5,17,"-095.5467813","+29.7148838"
"1648","482014330061","48",NA,"1",NA,748,502,246,240,15,157,0,54,0,14,6,922,640,282,276,15,190,0,57,0,14,6,"-095.5430112","+29.7127980"
"1649","482014330062","48",NA,"2",NA,669,387,282,280,22,239,1,15,0,3,2,862,519,343,340,23,293,1,18,0,5,3,"-095.5403938","+29.7125956"
"1650","482014330063","48",NA,"3",NA,406,282,124,117,15,87,0,11,0,4,7,617,412,205,196,20,147,0,16,0,13,9,"-095.5414968","+29.7101707"
"1651","482014330071","48",NA,"1",NA,543,312,231,231,0,15,0,216,0,0,0,767,437,330,329,0,19,0,310,0,0,1,"-095.5448936","+29.7117167"
"1652","482014330072","48",NA,"2",NA,560,295,265,265,10,4,0,242,0,9,0,740,390,350,346,13,8,3,313,0,9,4,"-095.5420165","+29.7070369"
"1653","482014331001","48",NA,"1",NA,1762,1286,476,470,42,302,6,113,0,7,6,2747,2118,629,617,54,408,6,124,1,24,12,"-095.5550340","+29.6996363"
"1654","482014331002","48",NA,"2",NA,466,365,101,99,14,71,1,10,0,3,2,651,500,151,149,20,99,1,24,0,5,2,"-095.5548594","+29.6929682"
"1655","482014332011","48",NA,"1",NA,1352,432,920,909,112,165,0,631,0,1,11,1703,641,1062,1051,130,202,0,718,0,1,11,"-095.5505044","+29.6997145"
"1656","482014332012","48",NA,"2",NA,1261,731,530,519,137,209,0,165,0,8,11,1741,1079,662,634,167,264,0,193,0,10,28,"-095.5488401","+29.6925883"
"1657","482014332013","48",NA,"3",NA,1158,267,891,874,204,51,0,614,0,5,17,1357,349,1008,983,222,68,0,686,0,7,25,"-095.5468671","+29.7001558"
"1658","482014332021","48",NA,"1",NA,1287,605,682,671,176,83,6,393,2,11,11,1646,875,771,758,188,95,6,448,2,19,13,"-095.5411960","+29.7009716"
"1659","482014332022","48",NA,"2",NA,580,362,218,212,64,9,1,138,0,0,6,828,577,251,244,79,10,1,150,0,4,7,"-095.5442422","+29.6938171"
"1660","482014332023","48",NA,"3",NA,1350,865,485,477,143,61,0,271,1,1,8,1893,1308,585,575,165,75,2,327,1,5,10,"-095.5395661","+29.6940075"
"1661","482014333001","48",NA,"1",NA,1522,647,875,849,316,104,1,424,3,1,26,1948,939,1009,963,338,122,1,495,3,4,46,"-095.5316611","+29.6997457"
"1662","482014333002","48",NA,"2",NA,1461,689,772,747,377,60,8,296,0,6,25,1841,928,913,870,433,77,8,345,0,7,43,"-095.5238095","+29.7004052"
"1663","482014333003","48",NA,"3",NA,1248,581,667,643,297,108,4,228,1,5,24,1562,815,747,711,315,123,4,263,1,5,36,"-095.5312383","+29.6934346"
"1664","482014334001","48",NA,"1",NA,704,388,316,307,72,216,0,14,0,5,9,864,476,388,379,89,266,0,19,0,5,9,"-095.5477318","+29.6896270"
"1665","482014334002","48",NA,"2",NA,1150,555,595,583,168,242,10,161,0,2,12,1514,772,742,720,191,336,10,177,0,6,22,"-095.5409273","+29.6846053"
"1666","482014334003","48",NA,"3",NA,554,355,199,196,43,147,0,6,0,0,3,747,504,243,240,49,185,0,6,0,0,3,"-095.5492186","+29.6886163"
"1667","482014334004","48",NA,"4",NA,839,598,241,235,71,22,2,138,0,2,6,1151,862,289,282,73,31,2,167,0,9,7,"-095.5430091","+29.6892608"
"1668","482014335031","48",NA,"1",NA,651,582,69,66,36,9,0,19,0,2,3,962,877,85,82,44,16,0,19,0,3,3,"-095.5517712","+29.6880964"
"1669","482014335032","48",NA,"2",NA,491,208,283,278,7,260,2,5,0,4,5,821,333,488,479,11,441,2,5,0,20,9,"-095.5554801","+29.6870505"
"1670","482014335041","48",NA,"1",NA,1067,845,222,220,40,116,8,21,0,35,2,1692,1356,336,333,64,168,8,23,0,70,3,"-095.5501782","+29.6846425"
"1671","482014335042","48",NA,"2",NA,943,663,280,276,27,197,2,23,0,27,4,1411,1045,366,352,30,250,2,27,0,43,14,"-095.5513549","+29.6780220"
"1672","482014335043","48",NA,"3",NA,407,313,94,91,15,68,0,5,0,3,3,636,498,138,127,20,97,0,7,0,3,11,"-095.5453252","+29.6784410"
"1673","482014335051","48",NA,"1",NA,754,613,141,138,22,116,0,0,0,0,3,1158,948,210,207,38,163,0,2,0,4,3,"-095.5518944","+29.6823828"
"1674","482014335052","48",NA,"2",NA,1133,895,238,226,26,66,0,129,0,5,12,1740,1433,307,290,35,90,0,155,0,10,17,"-095.5535813","+29.6835724"
"1675","482014335061","48",NA,"1",NA,788,548,240,238,5,227,0,4,0,2,2,1185,869,316,309,10,278,0,18,0,3,7,"-095.5547198","+29.6785425"
"1676","482014335062","48",NA,"2",NA,658,461,197,195,10,155,0,20,0,10,2,960,704,256,248,18,191,0,28,0,11,8,"-095.5536616","+29.6803619"
"1677","482014335071","48",NA,"1",NA,1093,769,324,318,23,261,0,32,0,2,6,1479,1064,415,406,45,319,0,32,0,10,9,"-095.5579220","+29.6790131"
"1678","482014335072","48",NA,"2",NA,420,206,214,196,20,62,2,112,0,0,18,576,302,274,249,24,83,2,140,0,0,25,"-095.5568456","+29.6827682"
"1679","482014335073","48",NA,"3",NA,774,329,445,440,23,390,1,11,0,15,5,1090,485,605,599,30,529,1,18,0,21,6,"-095.5570734","+29.6761946"
"1680","482014336011","48",NA,"1",NA,576,395,181,173,21,128,0,17,0,7,8,883,638,245,230,21,179,1,19,0,10,15,"-095.5553637","+29.6666881"
"1681","482014336012","48",NA,"2",NA,1431,922,509,496,93,328,1,71,0,3,13,1954,1315,639,624,109,421,2,82,0,10,15,"-095.5572682","+29.6689859"
"1682","482014336021","48",NA,"1",NA,809,311,498,480,31,402,0,43,1,3,18,1079,448,631,605,40,511,0,49,2,3,26,"-095.5585464","+29.6732260"
"1683","482014336022","48",NA,"2",NA,733,375,358,347,31,304,0,11,1,0,11,1124,610,514,491,40,436,0,13,1,1,23,"-095.5580453","+29.6714410"
"1684","482014336023","48",NA,"3",NA,1025,399,626,607,33,485,2,86,1,0,19,1504,619,885,862,41,697,6,113,1,4,23,"-095.5505164","+29.6732660"
"1685","482014401011","48",NA,"1",NA,1618,1288,330,315,102,80,5,126,0,2,15,2269,1895,374,357,111,90,8,140,0,8,17,"-095.5595870","+29.6506227"
"1686","482014401021","48",NA,"1",NA,1019,261,758,742,127,522,5,85,0,3,16,1300,338,962,942,137,705,5,92,0,3,20,"-095.5445669","+29.6399481"
"1687","482014401022","48",NA,"2",NA,1626,625,1001,973,470,373,5,115,0,10,28,2023,873,1150,1113,519,458,6,120,0,10,37,"-095.5479455","+29.6459474"
"1688","482014401023","48",NA,"3",NA,1017,160,857,830,46,648,1,134,0,1,27,1233,219,1014,978,55,770,1,151,0,1,36,"-095.5314921","+29.6339736"
"1689","482014501001","48",NA,"1",NA,1354,151,1203,1165,928,17,0,214,1,5,38,1908,245,1663,1591,1245,22,2,313,1,8,72,"-095.5669287","+29.7772428"
"1690","482014502001","48",NA,"1",NA,1336,112,1224,1185,1066,15,3,95,0,6,39,2076,194,1882,1791,1602,24,3,148,0,14,91,"-095.5857849","+29.7792527"
"1691","482014502002","48",NA,"2",NA,1739,203,1536,1492,1113,118,1,253,0,7,44,2523,274,2249,2163,1656,132,1,358,0,16,86,"-095.5787749","+29.7782723"
"1692","482014502003","48",NA,"3",NA,771,51,720,707,614,6,0,87,0,0,13,1150,92,1058,1021,873,8,0,134,0,6,37,"-095.5718279","+29.7801891"
"1693","482014503011","48",NA,"1",NA,622,74,548,515,401,15,2,90,0,7,33,951,134,817,758,591,22,2,134,0,9,59,"-095.5924248","+29.7790221"
"1694","482014503012","48",NA,"2",NA,1417,455,962,922,551,259,0,105,0,7,40,1993,684,1309,1236,694,381,0,139,0,22,73,"-095.5953353","+29.7731890"
"1695","482014503021","48",NA,"1",NA,807,175,632,604,441,40,0,111,0,12,28,973,248,725,690,496,46,0,126,0,22,35,"-095.5970354","+29.7828419"
"1696","482014503022","48",NA,"2",NA,961,207,754,700,460,106,5,124,0,5,54,1162,278,884,811,501,153,5,143,0,9,73,"-095.6006855","+29.7789760"
"1697","482014503023","48",NA,"3",NA,1211,337,874,827,414,283,3,118,0,9,47,1672,475,1197,1122,560,410,4,136,0,12,75,"-095.6038343","+29.7765474"
"1698","482014503024","48",NA,"4",NA,945,352,593,580,202,332,0,46,0,0,13,1511,550,961,937,306,554,0,73,0,4,24,"-095.5966769","+29.7780139"
"1699","482014504011","48",NA,"1",NA,598,127,471,453,322,54,0,77,0,0,18,832,175,657,625,447,95,0,83,0,0,32,"-095.6097800","+29.7749492"
"1700","482014504012","48",NA,"2",NA,1154,253,901,857,422,253,2,171,0,9,44,1348,286,1062,1005,495,286,2,213,0,9,57,"-095.6095538","+29.7709920"
"1701","482014504021","48",NA,"1",NA,737,144,593,555,285,155,4,105,0,6,38,837,177,660,614,305,182,4,117,0,6,46,"-095.6194193","+29.7818071"
"1702","482014504022","48",NA,"2",NA,1108,247,861,808,625,93,0,87,0,3,53,1462,364,1098,1018,793,114,0,103,0,8,80,"-095.6114019","+29.7787726"
"1703","482014505001","48",NA,"1",NA,1078,89,989,960,798,30,3,129,0,0,29,1331,131,1200,1142,933,44,5,158,0,2,58,"-095.6354937","+29.7814297"
"1704","482014505002","48",NA,"2",NA,1641,277,1364,1320,990,110,3,210,0,7,44,2055,364,1691,1627,1222,144,3,247,2,9,64,"-095.6336106","+29.7746984"
"1705","482014506001","48",NA,"1",NA,672,68,604,570,521,9,2,36,0,2,34,992,126,866,812,737,16,3,54,0,2,54,"-095.6147753","+29.7645979"
"1706","482014506002","48",NA,"2",NA,1424,289,1135,1102,747,171,3,178,0,3,33,1949,424,1525,1462,1015,229,5,209,0,4,63,"-095.6096747","+29.7667067"
"1707","482014506003","48",NA,"3",NA,1141,232,909,878,593,186,1,91,0,7,31,1385,298,1087,1021,675,225,3,111,0,7,66,"-095.6163028","+29.7709259"
"1708","482014506004","48",NA,"4",NA,754,158,596,579,351,132,3,88,0,5,17,968,213,755,730,437,182,4,102,0,5,25,"-095.6217966","+29.7762792"
"1709","482014507001","48",NA,"1",NA,1008,104,904,879,808,20,0,49,0,2,25,1467,160,1307,1258,1148,26,0,79,0,5,49,"-095.6019614","+29.7673995"
"1710","482014507002","48",NA,"2",NA,1897,117,1780,1746,1562,5,4,172,0,3,34,2793,201,2592,2499,2258,8,5,221,0,7,93,"-095.5694992","+29.7673289"
"1711","482014507003","48",NA,"3",NA,1771,102,1669,1611,1519,6,2,73,0,11,58,2505,163,2342,2230,2092,6,2,109,0,21,112,"-095.5908122","+29.7650809"
"1712","482014508011","48",NA,"1",NA,776,147,629,607,446,82,2,71,0,6,22,945,189,756,721,531,102,2,80,0,6,35,"-095.5680149","+29.7598221"
"1713","482014508012","48",NA,"2",NA,875,193,682,658,227,386,2,34,0,9,24,1124,253,871,836,251,530,2,43,1,9,35,"-095.5741012","+29.7592097"
"1714","482014508031","48",NA,"1",NA,736,78,658,626,582,10,2,19,0,13,32,999,122,877,826,766,12,2,29,0,17,51,"-095.5651980","+29.7536751"
"1715","482014508032","48",NA,"2",NA,1495,519,976,966,339,542,2,76,0,7,10,2194,753,1441,1422,437,877,2,98,0,8,19,"-095.5718529","+29.7535449"
"1716","482014508033","48",NA,"3",NA,1037,338,699,685,284,298,6,83,1,13,14,1464,513,951,926,351,455,8,95,1,16,25,"-095.5681004","+29.7515179"
"1717","482014508041","48",NA,"1",NA,1168,361,807,785,348,321,0,106,0,10,22,1492,505,987,960,385,442,0,122,0,11,27,"-095.5606449","+29.7560074"
"1718","482014508042","48",NA,"2",NA,1017,609,408,366,93,225,0,40,0,8,42,1531,927,604,549,129,353,5,44,0,18,55,"-095.5608492","+29.7502703"
"1719","482014509001","48",NA,"1",NA,1064,182,882,859,585,167,3,97,0,7,23,1344,241,1103,1064,719,215,3,120,0,7,39,"-095.5623163","+29.7419374"
"1720","482014509002","48",NA,"2",NA,1276,273,1003,971,733,122,2,108,0,6,32,1541,329,1212,1160,877,161,2,114,0,6,52,"-095.5685161","+29.7422039"
"1721","482014510031","48",NA,"1",NA,929,248,681,653,203,367,5,63,0,15,28,1152,324,828,779,216,472,5,69,0,17,49,"-095.5870902","+29.7427274"
"1722","482014510032","48",NA,"2",NA,565,139,426,406,62,339,1,4,0,0,20,869,229,640,609,82,519,1,7,0,0,31,"-095.5865088","+29.7461062"
"1723","482014510033","48",NA,"3",NA,728,184,544,536,47,459,0,27,0,3,8,1094,272,822,811,58,716,0,34,0,3,11,"-095.5849627","+29.7454515"
"1724","482014510041","48",NA,"1",NA,825,171,654,631,317,239,0,72,0,3,23,1007,240,767,727,335,311,0,77,0,4,40,"-095.5831891","+29.7388718"
"1725","482014510042","48",NA,"2",NA,989,268,721,699,95,570,4,23,0,7,22,1298,324,974,940,101,790,6,36,0,7,34,"-095.5868118","+29.7386242"
"1726","482014510051","48",NA,"1",NA,413,126,287,282,33,218,1,22,0,8,5,527,159,368,355,36,288,1,22,0,8,13,"-095.5749925","+29.7406937"
"1727","482014510052","48",NA,"2",NA,820,257,563,526,131,351,3,31,0,10,37,1036,338,698,653,137,467,3,36,0,10,45,"-095.5737134","+29.7391728"
"1728","482014510053","48",NA,"3",NA,240,80,160,149,32,111,0,4,0,2,11,334,107,227,213,34,166,1,7,0,5,14,"-095.5750492","+29.7423928"
"1729","482014510061","48",NA,"1",NA,1363,228,1135,1090,809,74,1,198,2,6,45,1668,296,1372,1292,951,107,1,224,2,7,80,"-095.5798417","+29.7424920"
"1730","482014510062","48",NA,"2",NA,650,158,492,461,165,245,0,51,0,0,31,810,213,597,555,175,316,0,62,0,2,42,"-095.5741228","+29.7455544"
"1731","482014511001","48",NA,"1",NA,1311,163,1148,1089,886,64,1,121,7,10,59,1519,197,1322,1249,1008,73,1,146,7,14,73,"-095.5822057","+29.7617498"
"1732","482014511002","48",NA,"2",NA,1323,325,998,966,687,176,0,97,0,6,32,1648,443,1205,1151,761,267,0,114,0,9,54,"-095.5842351","+29.7521197"
"1733","482014511003","48",NA,"3",NA,946,295,651,637,258,293,0,80,1,5,14,1216,403,813,781,292,385,0,95,1,8,32,"-095.5745585","+29.7511662"
"1734","482014512001","48",NA,"1",NA,1160,137,1023,994,901,33,1,51,0,8,29,1430,179,1251,1203,1086,37,1,70,0,9,48,"-095.6019832","+29.7598980"
"1735","482014512002","48",NA,"2",NA,1036,176,860,829,709,28,5,85,0,2,31,1256,244,1012,968,829,34,5,96,0,4,44,"-095.5905406","+29.7525343"
"1736","482014513011","48",NA,"1",NA,527,113,414,409,92,290,0,23,0,4,5,669,159,510,501,105,368,0,24,0,4,9,"-095.5911592","+29.7377830"
"1737","482014513012","48",NA,"2",NA,509,65,444,417,249,86,2,71,0,9,27,637,91,546,509,278,125,2,95,0,9,37,"-095.5953119","+29.7394480"
"1738","482014513013","48",NA,"3",NA,511,132,379,374,104,257,0,12,0,1,5,713,176,537,532,117,398,0,12,0,5,5,"-095.5904786","+29.7395178"
"1739","482014513014","48",NA,"4",NA,1809,385,1424,1363,895,269,6,182,0,11,61,2277,536,1741,1633,1026,375,6,210,0,16,108,"-095.6014378","+29.7415609"
"1740","482014513021","48",NA,"1",NA,1318,194,1124,1064,906,65,1,89,0,3,60,1628,278,1350,1268,1070,81,1,109,0,7,82,"-095.5920826","+29.7465965"
"1741","482014513022","48",NA,"2",NA,1005,176,829,781,651,42,2,80,1,5,48,1249,234,1015,943,785,61,2,89,1,5,72,"-095.6010040","+29.7497005"
"1742","482014514011","48",NA,"1",NA,1402,308,1094,1050,603,344,3,99,0,1,44,1713,415,1298,1235,692,423,6,111,0,3,63,"-095.6098606","+29.7496373"
"1743","482014514012","48",NA,"2",NA,897,192,705,672,226,320,3,119,1,3,33,1122,274,848,803,239,383,4,168,1,8,45,"-095.6178048","+29.7511296"
"1744","482014514013","48",NA,"3",NA,704,151,553,518,414,28,0,72,0,4,35,872,186,686,641,508,46,0,82,0,5,45,"-095.6139635","+29.7510511"
"1745","482014514041","48",NA,"1",NA,1095,316,779,741,199,438,4,95,0,5,38,1404,407,997,946,234,582,4,120,1,5,51,"-095.6201492","+29.7483484"
"1746","482014514042","48",NA,"2",NA,1262,292,970,935,306,311,3,309,0,6,35,1547,360,1187,1125,350,366,4,398,0,7,62,"-095.6232819","+29.7507752"
"1747","482014514043","48",NA,"3",NA,1051,272,779,744,219,478,0,41,0,6,35,1318,374,944,903,246,597,0,54,0,6,41,"-095.6199076","+29.7525780"
"1748","482014514051","48",NA,"1",NA,1861,431,1430,1388,518,599,8,255,1,7,42,2369,562,1807,1730,644,741,9,324,1,11,77,"-095.6211734","+29.7412332"
"1749","482014514061","48",NA,"1",NA,1328,307,1021,986,276,639,4,66,0,1,35,1633,385,1248,1202,301,811,4,82,1,3,46,"-095.6159326","+29.7447229"
"1750","482014514062","48",NA,"2",NA,1108,272,836,795,443,255,0,82,1,14,41,1353,359,994,936,497,323,0,99,1,16,58,"-095.6101188","+29.7411346"
"1751","482014514071","48",NA,"1",NA,1336,482,854,827,265,505,3,42,0,12,27,1672,618,1054,1013,308,645,3,44,0,13,41,"-095.6163322","+29.7396410"
"1752","482014515011","48",NA,"1",NA,524,101,423,383,124,202,2,53,0,2,40,620,139,481,429,133,232,2,60,0,2,52,"-095.6219236","+29.7558004"
"1753","482014515012","48",NA,"2",NA,1353,285,1068,1039,386,421,8,224,0,0,29,1656,339,1317,1271,436,525,11,296,0,3,46,"-095.6239973","+29.7605997"
"1754","482014515013","48",NA,"3",NA,623,129,494,470,202,108,1,148,2,9,24,770,157,613,581,245,136,1,188,2,9,32,"-095.6217348","+29.7621489"
"1755","482014515021","48",NA,"1",NA,868,236,632,607,255,252,5,88,0,7,25,1011,282,729,700,276,310,5,102,0,7,29,"-095.6088402","+29.7574222"
"1756","482014515022","48",NA,"2",NA,1419,256,1163,1097,728,190,0,170,0,9,66,1672,314,1358,1273,804,246,0,214,0,9,85,"-095.6108825","+29.7600039"
"1757","482014516031","48",NA,"1",NA,1331,173,1158,1101,845,34,9,210,0,3,57,1662,254,1408,1335,989,50,10,282,0,4,73,"-095.6308496","+29.7600115"
"1758","482014516032","48",NA,"2",NA,1450,268,1182,1145,292,377,1,467,0,8,37,2010,360,1650,1604,370,516,1,706,0,11,46,"-095.6402092","+29.7575997"
"1759","482014516041","48",NA,"1",NA,1695,271,1424,1372,1015,66,5,280,0,6,52,2232,387,1845,1754,1254,91,5,390,0,14,91,"-095.6312241","+29.7692923"
"1760","482014516042","48",NA,"2",NA,1771,181,1590,1557,1092,190,0,274,0,1,33,2060,244,1816,1749,1172,206,0,366,0,5,67,"-095.6408227","+29.7635903"
"1761","482014516051","48",NA,"1",NA,2218,457,1761,1673,431,740,2,474,0,26,88,2892,557,2335,2212,549,957,5,663,1,37,123,"-095.6259461","+29.7437617"
"1762","482014516052","48",NA,"2",NA,1158,220,938,914,365,239,2,306,0,2,24,1425,286,1139,1108,425,296,2,377,0,8,31,"-095.6289095","+29.7535303"
"1763","482014516061","48",NA,"1",NA,1395,293,1102,1050,580,63,0,400,0,7,52,1862,413,1449,1350,716,112,0,507,0,15,99,"-095.6314666","+29.7433326"
"1764","482014516062","48",NA,"2",NA,919,248,671,652,170,254,1,226,0,1,19,1259,337,922,896,225,318,1,349,1,2,26,"-095.6399503","+29.7534214"
"1765","482014516063","48",NA,"3",NA,2100,461,1639,1579,1049,146,9,367,0,8,60,2762,630,2132,2026,1300,221,10,486,1,8,106,"-095.6400210","+29.7462279"
"1766","482014517001","48",NA,"1",NA,719,122,597,581,84,423,7,41,0,26,16,972,157,815,797,100,604,7,54,0,32,18,"-095.6418444","+29.7337372"
"1767","482014517002","48",NA,"2",NA,572,187,385,372,154,84,3,127,3,1,13,716,260,456,435,159,118,3,146,3,6,21,"-095.6259268","+29.7326725"
"1768","482014517003","48",NA,"3",NA,1166,308,858,836,153,590,0,73,0,20,22,1698,437,1261,1226,189,929,0,86,0,22,35,"-095.6316206","+29.7333833"
"1769","482014517004","48",NA,"4",NA,722,129,593,569,228,181,3,154,0,3,24,877,167,710,672,251,239,3,176,0,3,38,"-095.6354744","+29.7313067"
"1770","482014518001","48",NA,"1",NA,684,289,395,362,136,114,0,112,0,0,33,823,346,477,435,150,159,0,125,0,1,42,"-095.6216919","+29.7242411"
"1771","482014518002","48",NA,"2",NA,1211,472,739,721,193,392,3,124,0,9,18,1638,677,961,931,231,540,3,143,0,14,30,"-095.6199009","+29.7164278"
"1772","482014518003","48",NA,"3",NA,1082,317,765,742,201,385,4,148,0,4,23,1412,434,978,941,236,521,7,168,0,9,37,"-095.6268130","+29.7268415"
"1773","482014518004","48",NA,"4",NA,1170,428,742,718,271,258,2,174,0,13,24,1446,552,894,864,290,358,2,197,2,15,30,"-095.6342779","+29.7188585"
"1774","482014519021","48",NA,"1",NA,2087,220,1867,1824,679,181,1,959,0,4,43,2517,277,2240,2169,772,253,1,1131,1,11,71,"-095.5987045","+29.7225162"
"1775","482014519031","48",NA,"1",NA,923,226,697,672,50,565,3,30,0,24,25,1224,318,906,860,61,735,3,31,0,30,46,"-095.6109613","+29.7149107"
"1776","482014519032","48",NA,"2",NA,729,153,576,572,21,522,0,0,1,28,4,1020,209,811,804,21,745,0,0,1,37,7,"-095.6073728","+29.7163836"
"1777","482014519033","48",NA,"3",NA,473,93,380,365,13,300,0,26,0,26,15,683,138,545,527,13,450,0,31,0,33,18,"-095.6116169","+29.7172620"
"1778","482014519034","48",NA,"4",NA,917,261,656,637,77,485,0,54,0,21,19,1226,356,870,842,89,658,0,70,0,25,28,"-095.6077168","+29.7185787"
"1779","482014519041","48",NA,"1",NA,497,155,342,327,57,233,3,31,0,3,15,662,215,447,425,69,313,3,37,0,3,22,"-095.6152057","+29.7199968"
"1780","482014519042","48",NA,"2",NA,1777,603,1174,1142,391,286,5,439,1,20,32,2236,804,1432,1391,456,382,5,518,1,29,41,"-095.6126409","+29.7263464"
"1781","482014519043","48",NA,"3",NA,832,256,576,564,167,275,0,117,1,4,12,1068,328,740,718,194,380,0,136,1,7,22,"-095.6087559","+29.7216391"
"1782","482014520011","48",NA,"1",NA,894,205,689,661,170,392,0,90,0,9,28,1184,270,914,869,211,551,0,98,0,9,45,"-095.6091023","+29.7310454"
"1783","482014520012","48",NA,"2",NA,1262,319,943,931,169,655,2,100,3,2,12,1686,414,1272,1256,207,932,2,107,3,5,16,"-095.6174976","+29.7319537"
"1784","482014520013","48",NA,"3",NA,416,128,288,285,28,237,0,16,0,4,3,637,202,435,430,29,368,0,28,0,5,5,"-095.6075693","+29.7349135"
"1785","482014520014","48",NA,"4",NA,965,329,636,596,283,111,3,185,1,13,40,1171,408,763,709,314,148,6,218,1,22,54,"-095.6127433","+29.7329751"
"1786","482014520021","48",NA,"1",NA,966,196,770,753,212,466,1,60,0,14,17,1242,254,988,966,249,626,1,73,0,17,22,"-095.6021452","+29.7345736"
"1787","482014520022","48",NA,"2",NA,924,218,706,668,149,465,2,43,3,6,38,1190,288,902,855,165,612,2,61,3,12,47,"-095.6011145","+29.7316548"
"1788","482014520023","48",NA,"3",NA,1179,176,1003,950,386,412,0,135,1,16,53,1443,227,1216,1147,419,535,2,174,1,16,69,"-095.5973090","+29.7316787"
"1789","482014521011","48",NA,"1",NA,1810,302,1508,1452,727,461,2,252,3,7,56,2046,362,1684,1614,774,547,2,281,3,7,70,"-095.5844163","+29.7319193"
"1790","482014521012","48",NA,"2",NA,2119,340,1779,1739,937,434,2,333,0,33,40,2672,447,2225,2169,1114,626,2,391,0,36,56,"-095.5786166","+29.7232136"
"1791","482014521013","48",NA,"3",NA,1417,256,1161,1122,406,368,2,325,0,21,39,1639,303,1336,1293,458,435,2,377,0,21,43,"-095.5875579","+29.7299023"
"1792","482014521021","48",NA,"1",NA,1532,397,1135,1105,299,630,0,156,0,20,30,1896,540,1356,1318,351,768,0,178,0,21,38,"-095.5783081","+29.7347268"
"1793","482014521031","48",NA,"1",NA,626,143,483,473,95,318,1,55,0,4,10,828,192,636,620,112,445,1,55,0,7,16,"-095.5781458","+29.7304611"
"1794","482014521032","48",NA,"2",NA,976,305,671,648,72,540,0,24,0,12,23,1337,445,892,860,80,732,0,34,0,14,32,"-095.5737870","+29.7322195"
"1795","482014522021","48",NA,"1",NA,914,226,688,666,180,378,0,100,0,8,22,1092,289,803,766,192,450,0,113,0,11,37,"-095.5616855","+29.7227889"
"1796","482014522022","48",NA,"2",NA,812,215,597,576,113,404,0,55,0,4,21,1042,294,748,720,136,522,0,58,0,4,28,"-095.5665694","+29.7249754"
"1797","482014522023","48",NA,"3",NA,1029,268,761,728,123,484,1,118,2,0,33,1317,351,966,923,133,649,1,137,2,1,43,"-095.5691098","+29.7220406"
"1798","482014522031","48",NA,"1",NA,1354,426,928,889,221,545,2,104,0,17,39,1664,556,1108,1056,235,687,2,109,0,23,52,"-095.5636000","+29.7295561"
"1799","482014522032","48",NA,"2",NA,1070,352,718,693,158,467,2,52,2,12,25,1436,495,941,897,184,630,2,60,2,19,44,"-095.5605563","+29.7336047"
"1800","482014522041","48",NA,"1",NA,928,303,625,596,133,383,3,61,0,16,29,1122,362,760,715,151,470,3,70,0,21,45,"-095.5653822","+29.7331472"
"1801","482014522042","48",NA,"2",NA,606,173,433,431,124,235,0,66,0,6,2,711,213,498,491,136,270,0,79,0,6,7,"-095.5698274","+29.7304061"
"1802","482014522043","48",NA,"3",NA,580,216,364,347,51,267,2,27,0,0,17,784,313,471,445,54,359,2,27,0,3,26,"-095.5683128","+29.7350341"
"1803","482014523001","48",NA,"1",NA,1785,843,942,925,93,204,1,627,0,0,17,2226,1130,1096,1075,107,262,1,702,0,3,21,"-095.5654888","+29.7078193"
"1804","482014524011","48",NA,"1",NA,1195,717,478,460,70,119,0,265,1,5,18,1471,890,581,554,84,149,0,310,1,10,27,"-095.5789380","+29.7135098"
"1805","482014524012","48",NA,"2",NA,1054,405,649,640,84,236,3,311,0,6,9,1429,595,834,821,98,336,3,377,0,7,13,"-095.5839306","+29.7140385"
"1806","482014524013","48",NA,"3",NA,832,366,466,456,38,195,1,216,2,4,10,1076,489,587,566,42,270,1,242,2,9,21,"-095.5734639","+29.7142882"
"1807","482014524021","48",NA,"1",NA,1644,763,881,871,145,84,0,638,0,4,10,2152,1088,1064,1050,154,110,0,771,0,15,14,"-095.5790748","+29.7094115"
"1808","482014524022","48",NA,"2",NA,1356,758,598,595,84,135,2,365,0,9,3,1896,1147,749,738,107,193,2,420,0,16,11,"-095.5837973","+29.7057265"
"1809","482014525011","48",NA,"1",NA,502,258,244,243,4,138,0,97,0,4,1,745,435,310,307,4,184,0,114,0,5,3,"-095.5889197","+29.7054142"
"1810","482014525012","48",NA,"2",NA,1214,648,566,550,105,73,1,368,0,3,16,1740,999,741,716,128,115,1,456,0,16,25,"-095.5964095","+29.7094773"
"1811","482014525021","48",NA,"1",NA,799,371,428,428,15,350,0,63,0,0,0,1200,508,692,688,37,578,0,73,0,0,4,"-095.6066020","+29.7052387"
"1812","482014525022","48",NA,"2",NA,2174,962,1212,1196,164,276,4,750,0,2,16,2876,1319,1557,1538,192,422,4,913,0,7,19,"-095.6095333","+29.7104993"
"1813","482014525023","48",NA,"3",NA,654,198,456,453,52,104,0,296,0,1,3,836,257,579,570,62,152,0,352,0,4,9,"-095.6116630","+29.7053434"
"1814","482014526011","48",NA,"1",NA,1664,619,1045,1005,76,698,0,227,0,4,40,2472,906,1566,1510,102,1086,5,313,0,4,56,"-095.6394924","+29.7092840"
"1815","482014526012","48",NA,"2",NA,1193,463,730,703,38,572,0,88,0,5,27,1955,761,1194,1152,67,941,0,136,0,8,42,"-095.6387330","+29.7057372"
"1816","482014526021","48",NA,"1",NA,1905,623,1282,1249,139,386,0,720,3,1,33,2313,791,1522,1477,156,471,0,845,3,2,45,"-095.6192851","+29.7083010"
"1817","482014526022","48",NA,"2",NA,863,81,782,777,25,48,0,702,1,1,5,1054,111,943,933,28,74,0,829,1,1,10,"-095.6291054","+29.7080238"
"1818","482014527011","48",NA,"1",NA,1609,780,829,821,100,309,0,407,1,4,8,2084,1054,1030,1001,119,400,0,472,1,9,29,"-095.6185800","+29.7002873"
"1819","482014527012","48",NA,"2",NA,1900,390,1510,1495,64,346,0,1080,1,4,15,2473,566,1907,1888,75,445,0,1360,1,7,19,"-095.6193039","+29.6934114"
"1820","482014527021","48",NA,"1",NA,1407,230,1177,1157,58,271,0,824,0,4,20,1619,277,1342,1316,60,330,0,922,0,4,26,"-095.6253492","+29.6928952"
"1821","482014527022","48",NA,"2",NA,1695,305,1390,1387,46,403,0,937,0,1,3,2292,466,1826,1814,54,637,0,1122,0,1,12,"-095.6301697","+29.6986510"
"1822","482014527031","48",NA,"1",NA,957,328,629,624,46,501,0,76,0,1,5,1274,440,834,825,61,661,0,98,0,5,9,"-095.6397502","+29.6917409"
"1823","482014527032","48",NA,"2",NA,1942,262,1680,1651,75,671,0,896,0,9,29,2623,377,2246,2202,85,1000,0,1100,0,17,44,"-095.6389152","+29.6985904"
"1824","482014528011","48",NA,"1",NA,1864,593,1271,1245,170,396,0,679,0,0,26,2394,832,1562,1535,188,527,0,814,0,6,27,"-095.6105728","+29.6995497"
"1825","482014528012","48",NA,"2",NA,1794,499,1295,1269,172,694,0,396,3,4,26,2376,688,1688,1659,224,965,0,458,3,9,29,"-095.6094410","+29.6924794"
"1826","482014528013","48",NA,"3",NA,719,257,462,456,40,223,0,192,0,1,6,981,384,597,591,47,304,0,233,0,7,6,"-095.6057687","+29.7007301"
"1827","482014528021","48",NA,"1",NA,1804,767,1037,1027,92,421,0,506,2,6,10,2436,1113,1323,1311,103,606,0,589,2,11,12,"-095.6002446","+29.6998602"
"1828","482014528022","48",NA,"2",NA,1107,372,735,723,18,313,0,276,0,116,12,1576,557,1019,992,28,489,0,322,0,153,27,"-095.6010806","+29.6916382"
"1829","482014528023","48",NA,"3",NA,1345,709,636,623,47,345,3,202,0,26,13,1916,1050,866,836,60,508,3,225,1,39,30,"-095.5985110","+29.6940921"
"1830","482014529001","48",NA,"1",NA,1451,730,721,707,95,192,0,415,5,0,14,1932,1013,919,895,109,267,0,505,5,9,24,"-095.5900348","+29.7016720"
"1831","482014529002","48",NA,"2",NA,1674,1011,663,644,160,119,4,306,7,48,19,2342,1531,811,781,182,181,4,345,7,62,30,"-095.5919139","+29.6940805"
"1832","482014530011","48",NA,"1",NA,760,407,353,348,14,144,0,153,0,37,5,1123,658,465,459,14,214,0,183,0,48,6,"-095.5728836","+29.6899262"
"1833","482014530012","48",NA,"2",NA,1018,751,267,264,54,45,2,157,0,6,3,1332,1006,326,313,64,67,2,168,0,12,13,"-095.5731810","+29.6982379"
"1834","482014530021","48",NA,"1",NA,2016,1479,537,521,94,83,3,325,0,16,16,2674,2011,663,635,112,114,11,371,0,27,28,"-095.5799292","+29.6922833"
"1835","482014530022","48",NA,"2",NA,1882,1123,759,745,152,91,2,491,0,9,14,2467,1572,895,871,162,113,2,585,0,9,24,"-095.5814852","+29.6999974"
"1836","482014531001","48",NA,"1",NA,1015,415,600,587,64,195,0,325,0,3,13,1289,581,708,692,71,244,0,369,0,8,16,"-095.5644437","+29.7001318"
"1837","482014531002","48",NA,"2",NA,1551,1044,507,491,24,389,0,57,0,21,16,2356,1627,729,700,30,571,0,69,0,30,29,"-095.5677336","+29.6906524"
"1838","482014531003","48",NA,"3",NA,530,363,167,158,46,36,0,70,0,6,9,659,470,189,177,49,40,0,82,0,6,12,"-095.5628346","+29.6932530"
"1839","482014532011","48",NA,"1",NA,1251,794,457,443,16,216,0,185,0,26,14,1855,1222,633,611,44,317,1,211,0,38,22,"-095.5666596","+29.6877943"
"1840","482014532012","48",NA,"2",NA,1208,539,669,650,73,495,0,31,0,51,19,1691,805,886,856,93,661,3,36,0,63,30,"-095.5606016","+29.6872360"
"1841","482014532021","48",NA,"1",NA,1933,933,1000,962,194,424,3,325,6,10,38,2565,1372,1193,1145,227,533,4,360,6,15,48,"-095.5648992","+29.6796443"
"1842","482014532022","48",NA,"2",NA,1077,520,557,551,37,302,1,199,0,12,6,1663,916,747,734,44,445,3,223,0,19,13,"-095.5660685","+29.6856428"
"1843","482014533001","48",NA,"1",NA,1112,337,775,759,32,662,1,64,0,0,16,1803,544,1259,1229,34,1097,2,89,0,7,30,"-095.5651265","+29.6707995"
"1844","482014533002","48",NA,"2",NA,1162,370,792,781,56,317,8,391,2,7,11,1682,604,1078,1055,67,455,14,506,2,11,23,"-095.5651378","+29.6604777"
"1845","482014534011","48",NA,"1",NA,1182,527,655,640,138,288,0,205,0,9,15,1558,707,851,820,166,391,0,254,0,9,31,"-095.5793722","+29.6569803"
"1846","482014534012","48",NA,"2",NA,1139,693,446,433,165,151,1,108,2,6,13,1484,959,525,495,172,178,5,125,2,13,30,"-095.5745826","+29.6530506"
"1847","482014534031","48",NA,"1",NA,1065,353,712,698,33,408,1,252,2,2,14,1537,512,1025,1000,36,651,1,300,2,10,25,"-095.5863500","+29.6674350"
"1848","482014534032","48",NA,"2",NA,1847,869,978,967,65,594,2,265,0,41,11,2570,1335,1235,1218,73,796,2,302,0,45,17,"-095.5841000","+29.6717299"
"1849","482014534041","48",NA,"1",NA,739,368,371,358,47,115,1,194,0,1,13,948,494,454,440,49,165,1,221,1,3,14,"-095.5757203","+29.6593831"
"1850","482014534042","48",NA,"2",NA,834,611,223,213,79,77,0,52,0,5,10,1104,829,275,255,85,107,1,57,0,5,20,"-095.5820311","+29.6632545"
"1851","482014534043","48",NA,"3",NA,1717,746,971,958,118,486,1,352,0,1,13,2327,1054,1273,1254,137,645,1,455,0,16,19,"-095.5797385","+29.6700491"
"1852","482014534051","48",NA,"1",NA,768,116,652,652,17,8,3,602,0,22,0,1089,183,906,905,32,14,11,812,0,36,1,"-095.5776656","+29.6636007"
"1853","482014534052","48",NA,"2",NA,1237,443,794,758,81,414,0,248,1,14,36,1751,637,1114,1048,117,581,3,325,2,20,66,"-095.5734060","+29.6709807"
"1854","482014534053","48",NA,"3",NA,805,368,437,429,73,258,0,96,0,2,8,1122,542,580,571,81,367,1,110,3,9,9,"-095.5729411","+29.6642411"
"1855","482014535011","48",NA,"1",NA,537,103,434,434,26,319,1,76,0,12,0,772,153,619,614,30,464,1,107,0,12,5,"-095.5891786","+29.6739670"
"1856","482014535012","48",NA,"2",NA,1458,660,798,759,102,335,1,314,0,7,39,1963,978,985,936,115,441,1,363,1,15,49,"-095.5915536","+29.6596034"
"1857","482014535013","48",NA,"3",NA,879,360,519,511,33,306,0,166,0,6,8,1249,554,695,686,36,459,0,183,0,8,9,"-095.5904890","+29.6712397"
"1858","482014535014","48",NA,"4",NA,1868,801,1067,1043,178,315,0,543,0,7,24,2373,1094,1279,1247,215,395,1,626,0,10,32,"-095.5866388","+29.6630670"
"1859","482014535021","48",NA,"1",NA,1485,776,709,688,135,342,0,199,4,8,21,2004,1109,895,868,162,456,1,235,4,10,27,"-095.5939530","+29.6709503"
"1860","482014535022","48",NA,"2",NA,1307,739,568,556,121,297,0,129,3,6,12,1922,1145,777,756,137,463,0,145,3,8,21,"-095.6003853","+29.6727865"
"1861","482014536011","48",NA,"1",NA,1602,757,845,828,99,401,3,244,0,81,17,2161,1115,1046,1022,110,522,3,290,0,97,24,"-095.5912718","+29.6800729"
"1862","482014536031","48",NA,"1",NA,1294,435,859,840,119,534,0,180,0,7,19,1759,684,1075,1049,133,703,0,206,0,7,26,"-095.5722996","+29.6815500"
"1863","482014536032","48",NA,"2",NA,1188,607,581,567,85,112,0,358,0,12,14,1532,848,684,664,96,143,0,411,0,14,20,"-095.5805717","+29.6858574"
"1864","482014536041","48",NA,"1",NA,1450,910,540,535,67,176,2,262,0,28,5,1858,1203,655,638,74,233,2,297,0,32,17,"-095.5830522","+29.6820785"
"1865","482014536042","48",NA,"2",NA,1732,999,733,716,64,367,1,274,0,10,17,2289,1386,903,878,67,466,1,319,0,25,25,"-095.5802818","+29.6776243"
"1866","482014537011","48",NA,"1",NA,1889,792,1097,1074,134,364,0,574,0,2,23,2570,1165,1405,1367,154,494,0,710,0,9,38,"-095.6099821","+29.6853039"
"1867","482014537012","48",NA,"2",NA,1501,881,620,605,109,239,0,246,0,11,15,1961,1198,763,735,129,307,0,284,0,15,28,"-095.6087810","+29.6798590"
"1868","482014537021","48",NA,"1",NA,1324,576,748,730,113,349,0,207,0,61,18,1826,878,948,928,130,477,0,240,0,81,20,"-095.6010249","+29.6845787"
"1869","482014537022","48",NA,"2",NA,1752,731,1021,1006,79,644,4,240,0,39,15,2395,1018,1377,1337,88,901,4,287,1,56,40,"-095.5978738","+29.6815962"
"1870","482014538001","48",NA,"1",NA,1428,747,681,662,120,334,0,207,0,1,19,1963,1069,894,870,131,511,0,227,0,1,24,"-095.6089807","+29.6746289"
"1871","482014538002","48",NA,"2",NA,1298,693,605,592,206,175,0,205,0,6,13,1705,986,719,699,222,236,1,234,0,6,20,"-095.6038013","+29.6668406"
"1872","482014539011","48",NA,"1",NA,1424,276,1148,1127,69,340,3,711,0,4,21,1889,385,1504,1479,78,486,5,905,1,4,25,"-095.6289032","+29.6849683"
"1873","482014539012","48",NA,"2",NA,1669,345,1324,1300,91,305,1,899,0,4,24,2157,475,1682,1647,118,424,3,1098,0,4,35,"-095.6187067","+29.6847046"
"1874","482014539013","48",NA,"3",NA,1414,436,978,960,67,479,5,400,0,9,18,1915,606,1309,1283,88,683,5,496,1,10,26,"-095.6382489","+29.6864748"
"1875","482014539021","48",NA,"1",NA,1067,466,601,585,41,235,1,300,0,8,16,1410,628,782,762,52,327,1,371,0,11,20,"-095.6179198","+29.6768005"
"1876","482014539022","48",NA,"2",NA,1225,527,698,682,110,191,1,377,0,3,16,1530,704,826,801,131,247,1,419,0,3,25,"-095.6269887","+29.6786964"
"1877","482014539023","48",NA,"3",NA,920,400,520,515,111,164,2,238,0,0,5,1200,560,640,626,120,225,2,279,0,0,14,"-095.6193259","+29.6791964"
"1878","482014540001","48",NA,"1",NA,1675,794,881,846,191,391,2,259,0,3,35,2275,1138,1137,1094,239,521,4,327,0,3,43,"-095.6574195","+29.6961500"
"1879","482014540002","48",NA,"2",NA,2348,709,1639,1605,223,585,1,791,0,5,34,2986,978,2008,1957,259,728,1,960,0,9,51,"-095.6470906","+29.6947835"
"1880","482014541001","48",NA,"1",NA,850,225,625,601,95,163,0,342,0,1,24,1068,300,768,735,137,199,0,398,0,1,33,"-095.6506764","+29.7072763"
"1881","482014541002","48",NA,"2",NA,910,322,588,582,91,417,0,74,0,0,6,1452,503,949,937,106,740,0,91,0,0,12,"-095.6585236","+29.7014575"
"1882","482014541003","48",NA,"3",NA,866,396,470,456,175,161,2,111,0,7,14,1147,559,588,560,192,216,2,142,0,8,28,"-095.6580945","+29.7061967"
"1883","482014542001","48",NA,"1",NA,1622,914,708,680,208,316,7,138,0,11,28,2168,1292,876,833,239,417,7,159,0,11,43,"-095.6718817","+29.7041762"
"1884","482014542002","48",NA,"2",NA,1405,785,620,599,222,266,0,95,0,16,21,1809,1068,741,713,250,332,0,115,0,16,28,"-095.6659100","+29.7066728"
"1885","482014543021","48",NA,"1",NA,1092,400,692,676,78,301,2,289,0,6,16,1391,490,901,878,104,435,2,331,0,6,23,"-095.6640308","+29.7113993"
"1886","482014543022","48",NA,"2",NA,604,214,390,370,176,143,1,47,0,3,20,706,282,424,401,179,157,1,61,0,3,23,"-095.6691208","+29.7132264"
"1887","482014543023","48",NA,"3",NA,1878,840,1038,993,383,246,6,348,0,10,45,2382,1119,1263,1193,438,324,8,411,0,12,70,"-095.6742917","+29.7138233"
"1888","482014543024","48",NA,"4",NA,1777,884,893,878,332,360,2,176,0,8,15,2313,1176,1137,1108,395,481,2,222,0,8,29,"-095.6637213","+29.7192629"
"1889","482014543031","48",NA,"1",NA,1511,805,706,675,183,365,2,119,2,4,31,1977,1079,898,855,207,495,2,145,2,4,43,"-095.6564072","+29.7135693"
"1890","482014543032","48",NA,"2",NA,1144,517,627,606,197,261,0,145,1,2,21,1494,740,754,725,226,324,0,172,1,2,29,"-095.6484327","+29.7151736"
"1891","482014543041","48",NA,"1",NA,885,162,723,717,59,601,0,53,0,4,6,1385,234,1151,1140,79,982,0,75,0,4,11,"-095.6576974","+29.7189596"
"1892","482014543042","48",NA,"2",NA,1127,253,874,835,182,483,0,159,1,10,39,1391,313,1078,1036,189,640,0,192,1,14,42,"-095.6552898","+29.7287562"
"1893","482014543043","48",NA,"3",NA,1373,309,1064,1012,124,684,0,204,0,0,52,2054,441,1613,1520,155,1121,3,241,0,0,93,"-095.6578548","+29.7227135"
"1894","482014543051","48",NA,"1",NA,1145,197,948,930,88,669,0,173,0,0,18,1614,287,1327,1295,120,948,0,226,0,1,32,"-095.6469629","+29.7231707"
"1895","482014543052","48",NA,"2",NA,1263,270,993,959,187,445,2,316,3,6,34,1687,381,1306,1259,218,610,3,416,3,9,47,"-095.6507248","+29.7240871"
"1896","482014543053","48",NA,"3",NA,765,162,603,585,102,373,1,107,0,2,18,987,205,782,760,115,525,3,115,0,2,22,"-095.6488796","+29.7314282"
"1897","482014544001","48",NA,"1",NA,907,252,655,627,119,465,0,36,1,6,28,1046,303,743,710,125,535,1,39,3,7,33,"-095.6690868","+29.7454505"
"1898","482014545021","48",NA,"1",NA,1878,230,1648,1584,929,109,0,540,0,6,64,2672,343,2329,2185,1296,153,0,729,0,7,144,"-095.7173589","+29.7447248"
"1899","482014545031","48",NA,"1",NA,1979,211,1768,1679,1342,29,7,296,2,3,89,2575,310,2265,2169,1718,39,15,386,2,9,96,"-095.7090582","+29.7716569"
"1900","482014545041","48",NA,"1",NA,2775,609,2166,2063,1086,314,4,650,0,9,103,3782,861,2921,2759,1406,443,4,896,0,10,162,"-095.6939140","+29.7582959"
"1901","482014545042","48",NA,"2",NA,1569,147,1422,1378,1141,30,1,194,2,10,44,2131,217,1914,1824,1470,41,1,293,6,13,90,"-095.7103031","+29.7630068"
"1902","482014545051","48",NA,"1",NA,1895,228,1667,1607,873,48,0,669,0,17,60,2606,308,2298,2202,1167,68,0,939,0,28,96,"-095.7039990","+29.7801047"
"1903","482014546001","48",NA,"1",NA,1210,558,652,612,286,261,4,58,0,3,40,1730,823,907,843,372,372,4,92,0,3,64,"-095.7460220","+29.7825365"
"1904","482014546002","48",NA,"2",NA,1008,146,862,827,722,31,0,67,0,7,35,1344,240,1104,1044,911,39,0,87,0,7,60,"-095.7274991","+29.7785015"
"1905","482014546003","48",NA,"3",NA,1248,464,784,758,454,217,2,70,8,7,26,1540,582,958,921,521,280,2,92,11,15,37,"-095.7425239","+29.7787409"
"1906","482014546004","48",NA,"4",NA,980,250,730,683,524,93,6,60,0,0,47,1323,355,968,899,696,121,6,76,0,0,69,"-095.7269519","+29.7826177"
"1907","482014547001","48",NA,"1",NA,1105,147,958,888,789,29,7,62,0,1,70,1454,205,1249,1137,1004,34,10,76,0,13,112,"-095.7279690","+29.7723145"
"1908","482014547002","48",NA,"2",NA,1656,237,1419,1374,1154,94,0,118,0,8,45,2163,353,1810,1734,1455,119,1,144,0,15,76,"-095.7187504","+29.7660915"
"1909","482014547003","48",NA,"3",NA,1033,117,916,906,736,40,2,114,2,12,10,1379,174,1205,1193,963,54,2,159,2,13,12,"-095.7243112","+29.7581570"
"1910","482014547004","48",NA,"4",NA,1463,214,1249,1209,1039,65,0,97,3,5,40,1914,284,1630,1564,1352,87,0,113,3,9,66,"-095.7314091","+29.7666390"
"1911","482014548011","48",NA,"1",NA,1370,341,1029,971,851,37,3,72,0,8,58,1709,485,1224,1149,994,54,4,89,0,8,75,"-095.7416841","+29.7699137"
"1912","482014548012","48",NA,"2",NA,1439,528,911,851,479,243,4,119,2,4,60,1830,719,1111,1019,559,297,6,146,2,9,92,"-095.7466290","+29.7737760"
"1913","482014548021","48",NA,"1",NA,1095,239,856,801,672,45,6,71,0,7,55,1405,341,1064,980,810,63,6,92,0,9,84,"-095.7425372","+29.7606911"
"1914","482014548022","48",NA,"2",NA,1141,401,740,727,460,173,1,91,0,2,13,1493,552,941,905,551,233,1,118,0,2,36,"-095.7477294","+29.7681857"
"1915","482014548023","48",NA,"3",NA,1218,336,882,844,680,65,0,96,0,3,38,1637,508,1129,1052,842,93,4,110,0,3,77,"-095.7437272","+29.7641519"
"1916","482014549011","48",NA,"1",NA,1255,159,1096,1067,695,59,6,301,0,6,29,1724,222,1502,1427,953,78,6,379,0,11,75,"-095.7281549","+29.7516603"
"1917","482014549012","48",NA,"2",NA,1007,201,806,771,519,57,0,192,0,3,35,1381,291,1090,1039,687,75,2,271,0,4,51,"-095.7316424","+29.7552099"
"1918","482014549021","48",NA,"1",NA,1013,242,771,744,448,85,3,203,0,5,27,1453,373,1080,1033,627,122,3,275,0,6,47,"-095.7453662","+29.7556899"
"1919","482014549022","48",NA,"2",NA,2221,577,1644,1589,939,184,2,452,0,12,55,2987,790,2197,2110,1226,254,2,614,0,14,87,"-095.7459797","+29.7498316"
"1920","482014549023","48",NA,"3",NA,1876,430,1446,1374,770,146,4,444,2,8,72,2558,602,1956,1843,1035,201,4,589,2,12,113,"-095.7361737","+29.7514603"
"1921","482014549024","48",NA,"4",NA,1186,259,927,889,403,114,1,356,0,15,38,1754,374,1380,1310,561,179,1,546,0,23,70,"-095.7392397","+29.7425785"
"1922","482014550001","48",NA,"1",NA,1142,373,769,732,535,68,0,118,1,10,37,1561,543,1018,964,692,96,0,161,1,14,54,"-095.7545453","+29.7531228"
"1923","482014550002","48",NA,"2",NA,876,70,806,776,669,33,0,68,0,6,30,1195,125,1070,1012,865,50,0,86,0,11,58,"-095.7610660","+29.7558595"
"1924","482014551021","48",NA,"1",NA,898,153,745,715,563,50,0,97,0,5,30,1210,255,955,906,713,71,3,114,0,5,49,"-095.7720388","+29.7625936"
"1925","482014551022","48",NA,"2",NA,1535,373,1162,1095,941,76,3,59,0,16,67,2025,509,1516,1413,1198,104,6,84,0,21,103,"-095.7705159","+29.7695653"
"1926","482014551031","48",NA,"1",NA,812,347,465,439,338,57,3,39,0,2,26,1083,474,609,564,433,75,3,51,0,2,45,"-095.7552453","+29.7663356"
"1927","482014551032","48",NA,"2",NA,663,149,514,478,407,26,7,35,0,3,36,868,221,647,596,491,41,7,49,0,8,51,"-095.7653122","+29.7625287"
"1928","482014551033","48",NA,"3",NA,1447,419,1028,982,813,88,1,73,0,7,46,1906,609,1297,1231,1019,117,1,81,0,13,66,"-095.7576571","+29.7612862"
"1929","482014551041","48",NA,"1",NA,1196,307,889,846,685,116,2,43,0,0,43,1566,448,1118,1055,838,163,2,46,0,6,63,"-095.7594013","+29.7727741"
"1930","482014551042","48",NA,"2",NA,1186,344,842,801,729,27,5,38,2,0,41,1542,468,1074,1011,903,49,5,51,2,1,63,"-095.7614219","+29.7695158"
"1931","482014552001","48",NA,"1",NA,993,286,707,679,585,55,3,35,0,1,28,1304,434,870,834,702,84,3,42,0,3,36,"-095.7552770","+29.7800728"
"1932","482014552002","48",NA,"2",NA,1504,398,1106,1018,908,72,1,35,0,2,88,1929,564,1365,1237,1091,99,1,44,0,2,128,"-095.7634845","+29.7800532"
"1933","482014552003","48",NA,"3",NA,918,182,736,702,577,50,10,65,0,0,34,1198,248,950,897,740,64,11,78,0,4,53,"-095.7730213","+29.7798269"
"1934","482014553001","48",NA,"1",NA,6233,2620,3613,3404,1865,959,12,536,0,32,209,8170,3528,4642,4354,2266,1314,17,701,0,56,288,"-095.7931551","+29.7792637"
"1935","482014553002","48",NA,"2",NA,3575,1406,2169,2042,1225,479,9,300,3,26,127,4809,2011,2798,2612,1496,669,13,399,3,32,186,"-095.7832515","+29.7698998"
"1936","482015101001","48",NA,"1",NA,1381,290,1091,1049,779,146,3,118,0,3,42,1549,351,1198,1139,826,163,3,140,0,7,59,"-095.3711263","+29.7674684"
"1937","482015101002","48",NA,"2",NA,1149,310,839,792,585,73,0,129,0,5,47,1300,381,919,865,643,82,0,134,0,6,54,"-095.3717621","+29.7747393"
"1938","482015102011","48",NA,"1",NA,878,240,638,596,452,69,0,69,1,5,42,1033,309,724,673,495,93,2,77,1,5,51,"-095.3820047","+29.7643804"
"1939","482015102012","48",NA,"2",NA,1861,329,1532,1474,1228,91,0,145,0,10,58,1939,350,1589,1530,1267,100,1,152,0,10,59,"-095.3857825","+29.7647350"
"1940","482015102021","48",NA,"1",NA,1433,379,1054,1016,770,128,4,111,0,3,38,1597,450,1147,1085,823,130,8,121,0,3,62,"-095.3792257","+29.7726957"
"1941","482015102022","48",NA,"2",NA,1423,240,1183,1139,689,68,0,372,3,7,44,1596,266,1330,1284,747,77,0,448,3,9,46,"-095.3958238","+29.7653821"
"1942","482015102023","48",NA,"3",NA,1203,303,900,849,598,118,6,119,0,8,51,1301,337,964,888,621,125,7,127,0,8,76,"-095.3903086","+29.7721296"
"1943","482015103011","48",NA,"1",NA,1099,255,844,805,713,33,3,44,0,12,39,1395,322,1073,1012,908,39,3,49,0,13,61,"-095.3730808","+29.7819430"
"1944","482015103012","48",NA,"2",NA,1292,246,1046,1014,876,66,1,70,0,1,32,1460,277,1183,1126,972,72,1,76,0,5,57,"-095.3803802","+29.7807427"
"1945","482015103021","48",NA,"1",NA,752,119,633,593,555,7,0,25,0,6,40,1014,167,847,779,734,7,0,29,0,9,68,"-095.3804403","+29.7862326"
"1946","482015103022","48",NA,"2",NA,746,124,622,590,545,10,0,30,0,5,32,1003,166,837,778,728,10,0,35,0,5,59,"-095.3816413","+29.7893810"
"1947","482015103023","48",NA,"3",NA,639,67,572,559,525,9,0,19,2,4,13,851,83,768,733,692,9,0,25,2,5,35,"-095.3859806","+29.7844420"
"1948","482015104001","48",NA,"1",NA,799,144,655,625,583,15,0,25,0,2,30,1070,197,873,802,752,16,0,32,0,2,71,"-095.3898350","+29.7862035"
"1949","482015104002","48",NA,"2",NA,1193,229,964,930,811,42,0,72,0,5,34,1449,284,1165,1099,970,43,0,81,0,5,66,"-095.3923273","+29.7787854"
"1950","482015104003","48",NA,"3",NA,1290,274,1016,963,888,27,3,42,0,3,53,1654,343,1311,1206,1105,32,3,63,0,3,105,"-095.3947566","+29.7861213"
"1951","482015105001","48",NA,"1",NA,1037,164,873,828,719,45,0,59,0,5,45,1287,222,1065,992,864,52,1,67,0,8,73,"-095.4010295","+29.7878800"
"1952","482015105002","48",NA,"2",NA,1757,267,1490,1442,1220,71,0,145,0,6,48,1972,321,1651,1584,1331,80,0,167,0,6,67,"-095.4028368","+29.7803802"
"1953","482015105003","48",NA,"3",NA,1181,175,1006,950,794,72,0,82,0,2,56,1416,221,1195,1113,932,81,0,94,0,6,82,"-095.4070948","+29.7869506"
"1954","482015106011","48",NA,"1",NA,1088,244,844,801,531,87,0,175,2,6,43,1234,292,942,884,573,96,0,204,2,9,58,"-095.4064192","+29.7733226"
"1955","482015106012","48",NA,"2",NA,1832,345,1487,1406,1024,144,0,233,0,5,81,1924,373,1551,1462,1048,151,0,256,0,7,89,"-095.4003948","+29.7730212"
"1956","482015106021","48",NA,"1",NA,1162,256,906,854,675,56,0,114,0,9,52,1357,316,1041,961,743,65,2,139,0,12,80,"-095.4234788","+29.7745334"
"1957","482015106022","48",NA,"2",NA,735,157,578,552,418,42,1,86,0,5,26,862,188,674,634,479,44,1,103,1,6,40,"-095.4149656","+29.7758814"
"1958","482015106023","48",NA,"3",NA,2053,379,1674,1593,1291,127,1,173,0,1,81,2161,412,1749,1652,1323,142,1,184,0,2,97,"-095.4154345","+29.7724205"
"1959","482015107011","48",NA,"1",NA,866,288,578,538,365,81,0,84,2,6,40,922,310,612,567,373,90,1,94,2,7,45,"-095.4053426","+29.7642242"
"1960","482015107012","48",NA,"2",NA,1310,226,1084,1058,864,42,0,147,0,5,26,1425,250,1175,1131,907,51,0,165,0,8,44,"-095.4015622","+29.7650279"
"1961","482015107021","48",NA,"1",NA,977,140,837,802,628,48,2,122,1,1,35,1118,171,947,893,688,55,2,146,1,1,54,"-095.4011989","+29.7678130"
"1962","482015107022","48",NA,"2",NA,722,110,612,583,461,8,2,107,1,4,29,838,134,704,661,513,12,2,129,1,4,43,"-095.4064290","+29.7686591"
"1963","482015108011","48",NA,"1",NA,1315,209,1106,1055,859,55,3,134,0,4,51,1474,261,1213,1150,924,61,3,158,0,4,63,"-095.4124135","+29.7681515"
"1964","482015108012","48",NA,"2",NA,1272,157,1115,1074,921,38,0,109,0,6,41,1478,205,1273,1219,1045,44,0,119,0,11,54,"-095.4182205","+29.7684047"
"1965","482015108013","48",NA,"3",NA,1281,176,1105,1077,859,46,0,159,0,13,28,1452,210,1242,1195,938,59,0,185,0,13,47,"-095.4193136","+29.7636032"
"1966","482015108021","48",NA,"1",NA,840,92,748,721,653,12,1,49,0,6,27,970,120,850,805,732,12,1,54,0,6,45,"-095.4386021","+29.7713829"
"1967","482015108022","48",NA,"2",NA,1089,189,900,853,721,35,0,92,0,5,47,1237,233,1004,943,793,41,0,104,0,5,61,"-095.4241895","+29.7669094"
"1968","482015108031","48",NA,"1",NA,2259,284,1975,1899,1643,95,4,146,0,11,76,2444,314,2130,2034,1740,105,4,172,0,13,96,"-095.4191067","+29.7607793"
"1969","482015109011","48",NA,"1",NA,1424,311,1113,1059,760,52,4,238,0,5,54,1674,388,1286,1207,855,71,4,272,0,5,79,"-095.4230481","+29.7796669"
"1970","482015109012","48",NA,"2",NA,1644,329,1315,1248,925,103,0,217,1,2,67,1926,413,1513,1428,1033,119,0,270,2,4,85,"-095.4269481","+29.7822766"
"1971","482015109013","48",NA,"3",NA,1477,420,1057,1017,758,61,5,192,0,1,40,1693,504,1189,1129,838,68,5,211,2,5,60,"-095.4147774","+29.7802460"
"1972","482015109021","48",NA,"1",NA,705,300,405,388,348,23,1,16,0,0,17,866,376,490,468,413,28,1,23,0,3,22,"-095.4142137","+29.7862644"
"1973","482015109022","48",NA,"2",NA,2640,496,2144,2062,1617,182,4,253,0,6,82,3001,583,2418,2307,1823,203,5,266,0,10,111,"-095.4399338","+29.7867785"
"1974","482015110011","48",NA,"1",NA,1328,250,1078,1033,885,66,2,71,0,9,45,1608,333,1275,1213,1046,80,2,75,0,10,62,"-095.4417956","+29.8042846"
"1975","482015110012","48",NA,"2",NA,1095,268,827,789,693,55,2,39,0,0,38,1354,358,996,945,838,62,2,43,0,0,51,"-095.4434534","+29.7958431"
"1976","482015110031","48",NA,"1",NA,364,125,239,235,176,43,0,16,0,0,4,403,148,255,250,187,47,0,16,0,0,5,"-095.4355412","+29.8000788"
"1977","482015110032","48",NA,"2",NA,976,146,830,783,704,18,0,51,0,10,47,1211,197,1014,952,858,21,0,63,0,10,62,"-095.4334030","+29.7942834"
"1978","482015110033","48",NA,"3",NA,818,234,584,578,461,92,0,25,0,0,6,921,278,643,633,506,100,0,27,0,0,10,"-095.4359664","+29.7975448"
"1979","482015110041","48",NA,"1",NA,934,148,786,748,699,3,3,42,1,0,38,1194,222,972,907,845,4,4,51,1,2,65,"-095.4256493","+29.7940446"
"1980","482015110042","48",NA,"2",NA,545,172,373,365,298,30,0,37,0,0,8,570,188,382,371,303,31,0,37,0,0,11,"-095.4248133","+29.7975837"
"1981","482015111001","48",NA,"1",NA,1068,186,882,854,678,55,0,116,0,5,28,1282,232,1050,1006,806,57,0,138,0,5,44,"-095.4199412","+29.8109281"
"1982","482015111002","48",NA,"2",NA,1165,233,932,883,740,37,1,100,0,5,49,1383,301,1082,1009,839,41,1,123,0,5,73,"-095.4240969","+29.8061728"
"1983","482015111003","48",NA,"3",NA,1261,320,941,858,641,120,4,83,0,10,83,1435,394,1041,941,696,138,5,92,0,10,100,"-095.4312629","+29.8065459"
"1984","482015112011","48",NA,"1",NA,1166,235,931,886,774,25,1,78,0,8,45,1427,313,1114,1047,911,30,3,93,0,10,67,"-095.4142892","+29.7958654"
"1985","482015112012","48",NA,"2",NA,1209,195,1014,976,825,39,3,105,2,2,38,1429,256,1173,1113,944,43,3,118,2,3,60,"-095.4202253","+29.7964050"
"1986","482015112021","48",NA,"1",NA,1381,234,1147,1113,880,84,2,147,0,0,34,1587,282,1305,1260,991,95,3,171,0,0,45,"-095.4173739","+29.8072613"
"1987","482015112022","48",NA,"2",NA,1707,376,1331,1282,1031,72,4,165,0,10,49,1988,473,1515,1431,1148,84,5,183,0,11,84,"-095.4172455","+29.8026888"
"1988","482015113011","48",NA,"1",NA,1213,198,1015,979,872,50,2,47,0,8,36,1377,234,1143,1101,985,52,2,50,0,12,42,"-095.4026836","+29.8004427"
"1989","482015113012","48",NA,"2",NA,940,156,784,746,705,8,1,27,0,5,38,1162,206,956,893,839,12,1,33,0,8,63,"-095.4020865","+29.7939251"
"1990","482015113013","48",NA,"3",NA,587,165,422,389,316,25,2,40,0,6,33,686,189,497,455,380,26,2,41,0,6,42,"-095.4086127","+29.7932626"
"1991","482015113014","48",NA,"4",NA,780,168,612,586,506,30,6,43,1,0,26,983,233,750,696,602,39,6,48,1,0,54,"-095.4088355","+29.7999990"
"1992","482015113021","48",NA,"1",NA,999,143,856,824,771,17,3,21,0,12,32,1186,183,1003,954,901,17,3,21,0,12,49,"-095.3918071","+29.8011694"
"1993","482015113022","48",NA,"2",NA,1274,213,1061,1011,954,20,1,35,0,1,50,1540,272,1268,1205,1130,28,1,42,0,4,63,"-095.3916009","+29.7945314"
"1994","482015113023","48",NA,"3",NA,1075,182,893,859,762,46,2,38,0,11,34,1286,220,1066,1017,906,49,2,44,0,16,49,"-095.3972673","+29.7973437"
"1995","482015114001","48",NA,"1",NA,1000,147,853,813,771,9,4,24,0,5,40,1142,184,958,900,858,9,4,24,0,5,58,"-095.3861595","+29.7970888"
"1996","482015114002","48",NA,"2",NA,784,193,591,568,525,8,1,27,1,6,23,943,243,700,670,625,8,1,29,1,6,30,"-095.3796445","+29.7924371"
"1997","482015114003","48",NA,"3",NA,738,406,332,319,290,14,0,14,0,1,13,901,520,381,366,337,14,0,14,0,1,15,"-095.3827900","+29.7982224"
"1998","482015115011","48",NA,"1",NA,1321,310,1011,949,794,53,7,89,3,3,62,1524,375,1149,1064,885,60,9,102,3,5,85,"-095.4080197","+29.8089106"
"1999","482015115012","48",NA,"2",NA,1343,242,1101,1054,945,29,1,76,2,1,47,1634,334,1300,1234,1104,32,2,88,2,6,66,"-095.4026257","+29.8074718"
"2000","482015115021","48",NA,"1",NA,673,208,465,446,371,25,4,43,0,3,19,852,275,577,547,441,42,4,56,0,4,30,"-095.3864872","+29.8122353"
"2001","482015115022","48",NA,"2",NA,792,262,530,504,455,13,3,31,0,2,26,938,324,614,577,521,13,3,38,0,2,37,"-095.3843430","+29.8069934"
"2002","482015115023","48",NA,"3",NA,777,257,520,491,451,12,0,28,0,0,29,955,326,629,588,542,15,0,29,0,2,41,"-095.3887326","+29.8069832"
"2003","482015115024","48",NA,"4",NA,724,121,603,584,524,21,2,33,0,4,19,888,152,736,701,637,21,2,36,0,5,35,"-095.3952711","+29.8061189"
"2004","482015115025","48",NA,"5",NA,1016,254,762,725,658,24,5,37,0,1,37,1219,319,900,849,771,24,5,48,0,1,51,"-095.3949399","+29.8108147"
"2005","482015116001","48",NA,"1",NA,765,343,422,399,370,2,5,19,2,1,23,921,423,498,455,424,3,5,20,2,1,43,"-095.3742968","+29.7949233"
"2006","482015116002","48",NA,"2",NA,498,288,210,189,159,5,3,22,0,0,21,605,359,246,216,181,9,4,22,0,0,30,"-095.3744175","+29.8005226"
"2007","482015116003","48",NA,"3",NA,826,468,358,341,282,29,9,19,0,2,17,1005,607,398,378,309,33,10,24,0,2,20,"-095.3794857","+29.7996730"
"2008","482015116004","48",NA,"4",NA,1003,594,409,399,320,56,1,22,0,0,10,1228,772,456,436,348,65,1,22,0,0,20,"-095.3778172","+29.8081587"
"2009","482015201001","48",NA,"1",NA,2106,698,1408,1326,950,157,4,208,0,7,82,2600,888,1712,1578,1133,182,4,252,0,7,134,"-095.4604356","+29.7922757"
"2010","482015202001","48",NA,"1",NA,1161,118,1043,1024,875,23,0,121,0,5,19,1515,173,1342,1305,1109,26,0,165,0,5,37,"-095.4803227","+29.7893570"
"2011","482015202002","48",NA,"2",NA,678,342,336,321,172,86,0,57,1,5,15,998,527,471,437,227,135,0,67,1,7,34,"-095.4736486","+29.7921352"
"2012","482015202003","48",NA,"3",NA,780,133,647,633,550,28,0,52,0,3,14,982,183,799,759,659,31,0,66,0,3,40,"-095.4713875","+29.7884702"
"2013","482015203011","48",NA,"1",NA,876,372,504,469,390,35,0,44,0,0,35,1095,520,575,534,438,42,0,54,0,0,41,"-095.4719142","+29.7995102"
"2014","482015203012","48",NA,"2",NA,701,402,299,284,167,61,0,54,0,2,15,881,544,337,319,176,79,0,59,0,5,18,"-095.4720223","+29.7953667"
"2015","482015203021","48",NA,"1",NA,725,497,228,222,183,28,2,7,1,1,6,987,724,263,253,206,32,4,9,1,1,10,"-095.4795194","+29.8013096"
"2016","482015203022","48",NA,"2",NA,1103,404,699,675,495,52,2,119,0,7,24,1404,574,830,797,563,73,2,152,0,7,33,"-095.4805572","+29.7976750"
"2017","482015204001","48",NA,"1",NA,1139,810,329,308,178,96,5,26,2,1,21,1588,1217,371,346,195,112,5,31,2,1,25,"-095.4817758","+29.8109512"
"2018","482015204002","48",NA,"2",NA,1330,877,453,444,255,162,5,13,0,9,9,1814,1265,549,533,275,230,5,14,0,9,16,"-095.4738931","+29.8066160"
"2019","482015205011","48",NA,"1",NA,1222,939,283,270,184,35,5,37,0,9,13,1774,1434,340,327,221,41,6,50,0,9,13,"-095.4685737","+29.8127917"
"2020","482015205012","48",NA,"2",NA,1391,1117,274,262,232,21,1,6,0,2,12,1867,1566,301,287,257,21,1,6,0,2,14,"-095.4877092","+29.8274297"
"2021","482015205021","48",NA,"1",NA,477,372,105,103,41,59,0,3,0,0,2,676,558,118,116,45,68,0,3,0,0,2,"-095.4871734","+29.8348054"
"2022","482015205022","48",NA,"2",NA,1151,912,239,212,172,20,0,13,0,7,27,1673,1383,290,256,196,34,0,14,0,12,34,"-095.4988700","+29.8358168"
"2023","482015205023","48",NA,"3",NA,1549,1290,259,253,125,101,0,22,0,5,6,2294,1946,348,342,156,140,1,36,0,9,6,"-095.4858103","+29.8314448"
"2024","482015206011","48",NA,"1",NA,1103,738,365,346,139,25,8,170,0,4,19,1476,1054,422,396,166,27,8,187,0,8,26,"-095.4932106","+29.8119055"
"2025","482015206012","48",NA,"2",NA,538,499,39,36,28,0,0,8,0,0,3,852,806,46,40,28,0,0,9,0,3,6,"-095.4925581","+29.8178783"
"2026","482015206031","48",NA,"1",NA,685,601,84,76,58,3,0,4,0,11,8,1018,905,113,97,75,6,0,4,0,12,16,"-095.4871080","+29.8088137"
"2027","482015206032","48",NA,"2",NA,994,766,228,219,68,139,0,10,0,2,9,1445,1122,323,300,78,209,0,10,0,3,23,"-095.4869603","+29.8049379"
"2028","482015206041","48",NA,"1",NA,1024,768,256,237,197,15,4,21,0,0,19,1395,1094,301,277,220,21,6,26,0,4,24,"-095.4984310","+29.8069073"
"2029","482015206042","48",NA,"2",NA,1320,810,510,488,357,66,0,58,0,7,22,1673,1108,565,532,376,78,2,65,3,8,33,"-095.4925982","+29.8069238"
"2030","482015207001","48",NA,"1",NA,496,79,417,406,308,10,1,85,0,2,11,702,130,572,550,418,14,1,115,0,2,22,"-095.4891303","+29.8009368"
"2031","482015207002","48",NA,"2",NA,531,170,361,351,311,5,1,30,0,4,10,730,227,503,486,428,6,1,45,0,6,17,"-095.4890038","+29.7969506"
"2032","482015207003","48",NA,"3",NA,968,298,670,649,458,34,0,157,0,0,21,1378,431,947,894,625,51,0,216,0,2,53,"-095.4959954","+29.7991100"
"2033","482015207004","48",NA,"4",NA,1080,290,790,763,617,13,2,131,0,0,27,1619,473,1146,1083,885,13,2,180,0,3,63,"-095.5042388","+29.7998221"
"2034","482015210001","48",NA,"1",NA,999,716,283,278,174,86,0,18,0,0,5,1565,1142,423,416,236,145,0,32,0,3,7,"-095.5142350","+29.7975637"
"2035","482015210002","48",NA,"2",NA,563,139,424,408,350,10,0,41,0,7,16,724,208,516,486,421,14,0,43,1,7,30,"-095.5190615","+29.7930203"
"2036","482015211001","48",NA,"1",NA,1105,976,129,127,81,31,1,12,0,2,2,1669,1501,168,165,91,53,1,15,0,5,3,"-095.5229927","+29.8014984"
"2037","482015211002","48",NA,"2",NA,446,200,246,239,216,3,1,19,0,0,7,594,302,292,282,253,5,1,20,0,3,10,"-095.5183131","+29.8018800"
"2038","482015212011","48",NA,"1",NA,806,747,59,59,22,35,0,0,0,2,0,1251,1153,98,96,36,56,0,0,0,4,2,"-095.5035943","+29.8098496"
"2039","482015212012","48",NA,"2",NA,862,456,406,378,242,53,0,78,0,5,28,1120,647,473,435,265,68,0,95,0,7,38,"-095.5037268","+29.8066275"
"2040","482015212021","48",NA,"1",NA,1428,811,617,591,425,85,1,78,0,2,26,1852,1173,679,642,461,92,2,85,0,2,37,"-095.5176233","+29.8068468"
"2041","482015212022","48",NA,"2",NA,1736,966,770,748,430,145,0,156,0,17,22,2151,1275,876,833,487,163,1,164,0,18,43,"-095.5095409","+29.8069547"
"2042","482015213001","48",NA,"1",NA,783,433,350,333,217,30,6,80,0,0,17,1050,624,426,401,263,36,7,92,0,3,25,"-095.5219341","+29.8188432"
"2043","482015213002","48",NA,"2",NA,817,552,265,257,151,47,0,58,0,1,8,1179,860,319,307,171,66,0,67,0,3,12,"-095.5135487","+29.8185297"
"2044","482015213003","48",NA,"3",NA,1078,578,500,482,356,24,4,94,3,1,18,1395,802,593,558,396,39,4,114,3,2,35,"-095.5050659","+29.8161049"
"2045","482015213004","48",NA,"4",NA,933,499,434,425,186,82,0,153,0,4,9,1188,690,498,482,205,101,0,171,0,5,16,"-095.5139772","+29.8128055"
"2046","482015213005","48",NA,"5",NA,954,514,440,417,248,61,0,94,3,11,23,1221,700,521,491,282,82,0,111,3,13,30,"-095.5202932","+29.8129524"
"2047","482015214011","48",NA,"1",NA,751,696,55,52,31,19,0,1,1,0,3,1150,1073,77,72,41,22,0,3,1,5,5,"-095.4995763","+29.8276259"
"2048","482015214012","48",NA,"2",NA,1424,1384,40,39,11,25,0,1,0,2,1,2347,2282,65,62,20,39,0,1,0,2,3,"-095.5057266","+29.8311639"
"2049","482015214021","48",NA,"1",NA,1003,722,281,266,205,13,1,36,0,11,15,1317,972,345,325,244,20,4,37,0,20,20,"-095.5017543","+29.8230453"
"2050","482015214022","48",NA,"2",NA,1531,1404,127,124,78,21,12,9,0,4,3,2295,2137,158,154,96,33,12,9,0,4,4,"-095.5059837","+29.8265826"
"2051","482015215011","48",NA,"1",NA,774,609,165,164,103,31,4,26,0,0,1,1039,835,204,198,123,40,4,27,0,4,6,"-095.5246901","+29.8274878"
"2052","482015215012","48",NA,"2",NA,1129,915,214,202,166,15,1,20,0,0,12,1580,1326,254,238,185,22,1,30,0,0,16,"-095.5215804","+29.8233840"
"2053","482015215021","48",NA,"1",NA,773,514,259,245,191,21,3,28,0,2,14,976,680,296,282,216,25,4,33,0,4,14,"-095.5209644","+29.8291651"
"2054","482015215022","48",NA,"2",NA,1581,684,897,853,703,40,6,97,0,7,44,1941,907,1034,972,781,48,6,127,0,10,62,"-095.5134076","+29.8269678"
"2055","482015216001","48",NA,"1",NA,1532,1122,410,395,300,34,0,61,0,0,15,2014,1556,458,443,332,39,0,70,0,2,15,"-095.5288909","+29.8380553"
"2056","482015216002","48",NA,"2",NA,1061,683,378,349,37,295,10,7,0,0,29,1517,1030,487,456,48,378,11,8,0,11,31,"-095.5400834","+29.8519886"
"2057","482015217011","48",NA,"1",NA,766,466,300,292,68,192,7,22,0,3,8,1019,657,362,349,72,242,7,25,0,3,13,"-095.5170938","+29.8509952"
"2058","482015217012","48",NA,"2",NA,675,466,209,193,73,97,0,11,0,12,16,952,698,254,236,86,127,0,11,0,12,18,"-095.5186351","+29.8467362"
"2059","482015217013","48",NA,"3",NA,1157,442,715,688,196,457,5,23,0,7,27,1649,660,989,938,232,669,6,24,0,7,51,"-095.5357874","+29.8584307"
"2060","482015217021","48",NA,"1",NA,639,446,193,171,64,90,0,16,0,1,22,929,675,254,218,79,122,0,16,0,1,36,"-095.5123663","+29.8469744"
"2061","482015217022","48",NA,"2",NA,918,433,485,467,135,305,1,26,0,0,18,1279,644,635,602,167,399,1,35,0,0,33,"-095.5097396","+29.8486182"
"2062","482015217023","48",NA,"3",NA,1136,566,570,555,101,437,0,15,0,2,15,1557,821,736,704,110,569,0,15,0,10,32,"-095.5016414","+29.8439481"
"2063","482015218001","48",NA,"1",NA,2172,951,1221,1195,327,305,5,554,0,4,26,2718,1291,1427,1386,382,347,5,648,0,4,41,"-095.5497025","+29.8526013"
"2064","482015218002","48",NA,"2",NA,2057,1208,849,839,336,93,1,405,0,4,10,2540,1567,973,955,371,122,1,455,0,6,18,"-095.5508772","+29.8371256"
"2065","482015219001","48",NA,"1",NA,1994,409,1585,1534,1098,103,5,322,0,6,51,2357,518,1839,1765,1280,115,7,353,0,10,74,"-095.5561482","+29.8281761"
"2066","482015219002","48",NA,"2",NA,907,584,323,305,131,25,2,145,0,2,18,1152,776,376,345,141,32,3,167,0,2,31,"-095.5555974","+29.8161951"
"2067","482015219003","48",NA,"3",NA,751,241,510,495,353,39,0,101,0,2,15,898,328,570,547,389,42,0,112,0,4,23,"-095.5495811","+29.8139605"
"2068","482015219004","48",NA,"4",NA,664,506,158,149,46,74,1,26,0,2,9,1044,815,229,220,58,123,1,29,0,9,9,"-095.5588158","+29.8139177"
"2069","482015219005","48",NA,"5",NA,906,225,681,653,549,18,3,78,0,5,28,1145,344,801,759,632,24,6,92,0,5,42,"-095.5540645","+29.8198827"
"2070","482015220011","48",NA,"1",NA,511,318,193,183,104,44,1,26,1,7,10,605,392,213,203,111,56,1,27,1,7,10,"-095.5390770","+29.8238102"
"2071","482015220012","48",NA,"2",NA,1248,241,1007,983,773,66,1,142,0,1,24,1397,308,1089,1053,820,78,1,153,0,1,36,"-095.5385130","+29.8297802"
"2072","482015220021","48",NA,"1",NA,358,318,40,38,30,3,3,2,0,0,2,513,472,41,39,30,3,3,3,0,0,2,"-095.5276635","+29.8240991"
"2073","482015220022","48",NA,"2",NA,625,351,274,266,216,23,0,27,0,0,8,829,514,315,304,249,28,0,27,0,0,11,"-095.5288936","+29.8286991"
"2074","482015220023","48",NA,"3",NA,686,421,265,259,204,17,1,36,1,0,6,980,632,348,324,248,27,5,39,2,3,24,"-095.5327744","+29.8243268"
"2075","482015221011","48",NA,"1",NA,882,373,509,498,295,80,3,119,0,1,11,1133,547,586,573,324,106,5,134,0,4,13,"-095.5390993","+29.8205592"
"2076","482015221012","48",NA,"2",NA,703,460,243,237,128,69,0,40,0,0,6,968,676,292,284,154,88,0,42,0,0,8,"-095.5432683","+29.8205844"
"2077","482015221013","48",NA,"3",NA,1064,539,525,478,375,70,5,26,0,2,47,1448,808,640,569,423,93,10,41,0,2,71,"-095.5410295","+29.8155544"
"2078","482015221021","48",NA,"1",NA,895,536,359,351,171,151,0,24,0,5,8,1466,912,554,542,223,272,0,37,0,10,12,"-095.5298857","+29.8178752"
"2079","482015221022","48",NA,"2",NA,1256,511,745,708,620,26,1,55,1,5,37,1612,724,888,827,721,30,3,66,1,6,61,"-095.5314296","+29.8122607"
"2080","482015221023","48",NA,"3",NA,741,412,329,317,234,67,0,15,1,0,12,1108,683,425,408,271,117,0,18,1,1,17,"-095.5345138","+29.8193374"
"2081","482015222011","48",NA,"1",NA,1071,848,223,216,92,72,1,49,0,2,7,1666,1369,297,283,110,106,2,61,0,4,14,"-095.5275935","+29.8016777"
"2082","482015222012","48",NA,"2",NA,1755,921,834,810,640,46,1,116,0,7,24,2350,1338,1012,970,776,58,3,121,0,12,42,"-095.5373324","+29.8088554"
"2083","482015222021","48",NA,"1",NA,1553,1000,553,519,391,59,2,62,0,5,34,2212,1542,670,621,466,76,7,67,0,5,49,"-095.5377938","+29.8036414"
"2084","482015222022","48",NA,"2",NA,1183,708,475,453,335,47,4,59,0,8,22,1643,1091,552,508,370,52,7,71,0,8,44,"-095.5379697","+29.7977659"
"2085","482015223011","48",NA,"1",NA,1233,417,816,785,616,65,5,97,0,2,31,1508,579,929,891,692,83,5,108,0,3,38,"-095.5280223","+29.7934807"
"2086","482015223012","48",NA,"2",NA,909,663,246,236,143,60,0,32,0,1,10,1248,946,302,292,176,79,0,36,0,1,10,"-095.5226378","+29.7897714"
"2087","482015223013","48",NA,"3",NA,719,518,201,186,97,18,4,65,0,2,15,1036,799,237,220,115,18,4,81,0,2,17,"-095.5265852","+29.7870022"
"2088","482015223021","48",NA,"1",NA,1391,1086,305,287,177,36,4,68,0,2,18,1898,1524,374,351,217,50,7,75,0,2,23,"-095.5422460","+29.7896227"
"2089","482015223022","48",NA,"2",NA,636,258,378,373,239,62,0,70,0,2,5,720,302,418,413,262,70,1,78,0,2,5,"-095.5355073","+29.7869682"
"2090","482015223023","48",NA,"3",NA,788,358,430,414,328,15,6,56,0,9,16,1023,513,510,482,389,15,6,63,0,9,28,"-095.5362407","+29.7916232"
"2091","482015224011","48",NA,"1",NA,668,179,489,468,395,16,4,49,3,1,21,830,237,593,554,461,24,6,53,3,7,39,"-095.5497229","+29.8085220"
"2092","482015224012","48",NA,"2",NA,960,254,706,679,596,13,2,64,0,4,27,1216,376,840,797,705,22,2,64,0,4,43,"-095.5486901","+29.8004130"
"2093","482015224013","48",NA,"3",NA,1468,772,696,649,511,82,3,48,0,5,47,1860,1028,832,761,594,97,4,60,0,6,71,"-095.5499236","+29.7942096"
"2094","482015224014","48",NA,"4",NA,1357,878,479,469,258,106,7,91,0,7,10,1907,1303,604,584,321,137,13,106,0,7,20,"-095.5489354","+29.7876966"
"2095","482015224021","48",NA,"1",NA,722,316,406,381,314,17,8,37,0,5,25,943,464,479,445,358,26,8,42,0,11,34,"-095.5584496","+29.7910581"
"2096","482015224022","48",NA,"2",NA,877,808,69,58,29,22,5,0,0,2,11,1483,1392,91,77,41,25,5,1,0,5,14,"-095.5555174","+29.8110053"
"2097","482015224023","48",NA,"3",NA,1076,301,775,748,675,17,2,51,0,3,27,1355,417,938,889,803,17,2,58,1,8,49,"-095.5590893","+29.8046378"
"2098","482015225001","48",NA,"1",NA,613,57,556,539,468,13,3,55,0,0,17,816,90,726,704,610,21,4,69,0,0,22,"-095.4885344","+29.7908124"
"2099","482015225002","48",NA,"2",NA,907,80,827,816,702,12,0,91,0,11,11,1275,119,1156,1133,963,18,0,138,0,14,23,"-095.5130839","+29.7885890"
"2100","482015225003","48",NA,"3",NA,987,67,920,895,794,0,8,86,0,7,25,1344,102,1242,1200,1084,0,8,97,0,11,42,"-095.4952852","+29.7889991"
"2101","482015225004","48",NA,"4",NA,1133,124,1009,969,856,6,0,103,0,4,40,1610,207,1403,1333,1184,9,0,135,0,5,70,"-095.5051403","+29.7913321"
"2102","482015301011","48",NA,"1",NA,551,291,260,252,185,63,0,4,0,0,8,712,391,321,304,219,79,0,4,0,2,17,"-095.4478229","+29.8156294"
"2103","482015301012","48",NA,"2",NA,1646,1049,597,580,365,183,0,24,1,7,17,2320,1607,713,687,412,236,0,25,1,13,26,"-095.4552364","+29.8164085"
"2104","482015301013","48",NA,"3",NA,688,365,323,317,212,93,2,10,0,0,6,906,513,393,377,250,114,2,10,1,0,16,"-095.4477671","+29.8131923"
"2105","482015301021","48",NA,"1",NA,524,342,182,182,54,109,0,18,0,1,0,699,491,208,206,61,124,0,18,0,3,2,"-095.4624565","+29.8164475"
"2106","482015301022","48",NA,"2",NA,713,474,239,234,183,35,0,13,0,3,5,991,703,288,274,212,46,0,13,0,3,14,"-095.4505929","+29.8084756"
"2107","482015302001","48",NA,"1",NA,1199,234,965,920,798,60,0,54,0,8,45,1544,334,1210,1133,979,69,0,73,0,12,77,"-095.4068163","+29.8160244"
"2108","482015302002","48",NA,"2",NA,1220,403,817,786,641,26,3,107,0,9,31,1512,553,959,901,727,29,3,132,0,10,58,"-095.4248730","+29.8161831"
"2109","482015302003","48",NA,"3",NA,568,202,366,351,298,24,0,26,0,3,15,710,267,443,417,351,29,0,34,0,3,26,"-095.4400734","+29.8162235"
"2110","482015303001","48",NA,"1",NA,1037,343,694,673,156,495,0,20,0,2,21,1299,489,810,788,167,599,0,20,0,2,22,"-095.3849694","+29.8165783"
"2111","482015303002","48",NA,"2",NA,1108,373,735,716,193,512,0,8,1,2,19,1381,524,857,831,223,597,0,8,1,2,26,"-095.3955045","+29.8154865"
"2112","482015304001","48",NA,"1",NA,1423,596,827,812,61,742,0,4,2,3,15,1910,839,1071,1047,74,958,0,5,2,8,24,"-095.3923787","+29.8266044"
"2113","482015304002","48",NA,"2",NA,641,315,326,324,61,251,0,9,0,3,2,871,468,403,392,75,301,0,10,0,6,11,"-095.3837888","+29.8256649"
"2114","482015305011","48",NA,"1",NA,572,260,312,292,9,280,0,3,0,0,20,740,370,370,347,13,328,0,6,0,0,23,"-095.3935621","+29.8388085"
"2115","482015305012","48",NA,"2",NA,888,495,393,375,53,298,1,23,0,0,18,1201,710,491,472,62,383,1,26,0,0,19,"-095.3943900","+29.8418528"
"2116","482015305021","48",NA,"1",NA,806,348,458,446,36,403,0,4,0,3,12,1062,498,564,546,49,487,0,7,0,3,18,"-095.3995740","+29.8393485"
"2117","482015305022","48",NA,"2",NA,1079,640,439,428,50,371,1,6,0,0,11,1428,926,502,489,51,429,1,6,0,2,13,"-095.3959959","+29.8329248"
"2118","482015306001","48",NA,"1",NA,1359,514,845,818,340,404,5,59,0,10,27,1646,691,955,903,367,459,5,59,0,13,52,"-095.4037458","+29.8249187"
"2119","482015306002","48",NA,"2",NA,535,304,231,230,91,137,0,2,0,0,1,683,432,251,249,93,154,0,2,0,0,2,"-095.4067690","+29.8328489"
"2120","482015306003","48",NA,"3",NA,776,466,310,303,145,146,2,7,0,3,7,1022,679,343,330,155,159,2,9,0,5,13,"-095.4070606","+29.8410672"
"2121","482015307011","48",NA,"1",NA,1139,519,620,613,120,478,0,9,6,0,7,1557,766,791,783,136,623,0,15,9,0,8,"-095.4088157","+29.8630702"
"2122","482015307021","48",NA,"1",NA,1288,964,324,317,75,233,0,4,0,5,7,1789,1382,407,395,82,303,0,4,0,6,12,"-095.3996658","+29.8502226"
"2123","482015307022","48",NA,"2",NA,847,568,279,272,30,237,0,2,0,3,7,1457,945,512,503,33,465,0,2,0,3,9,"-095.4079896","+29.8500329"
"2124","482015307023","48",NA,"3",NA,939,625,314,305,145,130,8,11,0,11,9,1176,830,346,332,150,152,8,11,0,11,14,"-095.4066967","+29.8548774"
"2125","482015308001","48",NA,"1",NA,1044,291,753,731,26,696,6,0,2,1,22,1445,467,978,943,60,873,6,0,2,2,35,"-095.4177386","+29.8608576"
"2126","482015308002","48",NA,"2",NA,649,190,459,442,24,404,4,6,0,4,17,841,280,561,542,31,495,4,6,0,6,19,"-095.4241804","+29.8557793"
"2127","482015308003","48",NA,"3",NA,848,84,764,749,141,586,2,8,0,12,15,1023,150,873,856,162,671,2,8,0,13,17,"-095.4230508","+29.8438605"
"2128","482015308004","48",NA,"4",NA,665,151,514,497,66,419,3,9,0,0,17,824,235,589,567,70,485,3,9,0,0,22,"-095.4183739","+29.8475610"
"2129","482015309001","48",NA,"1",NA,977,531,446,415,252,150,0,9,0,4,31,1221,723,498,459,273,172,0,10,0,4,39,"-095.4135469","+29.8362345"
"2130","482015309002","48",NA,"2",NA,1250,364,886,866,708,131,0,25,0,2,20,1648,512,1136,1102,903,166,0,30,0,3,34,"-095.4230038","+29.8386122"
"2131","482015309003","48",NA,"3",NA,1215,161,1054,1005,960,20,0,24,0,1,49,1597,229,1368,1297,1247,23,1,25,0,1,71,"-095.4226416","+29.8336384"
"2132","482015310001","48",NA,"1",NA,1217,239,978,940,834,33,0,69,0,4,38,1614,326,1288,1210,1069,49,3,85,0,4,78,"-095.4257608","+29.8245777"
"2133","482015310002","48",NA,"2",NA,2024,492,1532,1465,1302,57,0,94,0,12,67,2682,732,1950,1825,1632,68,1,104,0,20,125,"-095.4164468","+29.8255415"
"2134","482015311001","48",NA,"1",NA,1012,203,809,759,695,12,1,42,4,5,50,1316,296,1020,935,845,24,1,54,4,7,85,"-095.4420959","+29.8254514"
"2135","482015311002","48",NA,"2",NA,1326,337,989,966,846,30,2,86,1,1,23,2061,500,1561,1487,1298,45,2,135,1,6,74,"-095.4325226","+29.8233343"
"2136","482015312001","48",NA,"1",NA,834,388,446,440,204,172,5,19,0,40,6,1185,591,594,579,237,271,7,23,0,41,15,"-095.4542943","+29.8293853"
"2137","482015312002","48",NA,"2",NA,1108,257,851,813,751,16,2,40,0,4,38,1341,308,1033,976,899,20,3,45,0,9,57,"-095.4494635","+29.8287871"
"2138","482015312003","48",NA,"3",NA,705,136,569,553,502,25,4,20,0,2,16,855,168,687,660,597,33,5,20,0,5,27,"-095.4476834","+29.8230523"
"2139","482015313001","48",NA,"1",NA,970,653,317,309,108,191,0,9,0,1,8,1374,959,415,399,140,249,0,9,0,1,16,"-095.4507645","+29.8184055"
"2140","482015313002","48",NA,"2",NA,1319,428,891,844,696,83,5,47,0,13,47,1555,549,1006,943,761,101,5,56,0,20,63,"-095.4675315","+29.8239016"
"2141","482015313003","48",NA,"3",NA,888,398,490,469,194,242,0,28,0,5,21,1084,508,576,554,211,305,0,33,0,5,22,"-095.4605800","+29.8245467"
"2142","482015313004","48",NA,"4",NA,622,346,276,261,84,172,1,2,0,2,15,804,471,333,318,96,217,1,2,0,2,15,"-095.4577169","+29.8221466"
"2143","482015314001","48",NA,"1",NA,1710,604,1106,1050,920,83,4,40,0,3,56,2017,777,1240,1167,1000,114,4,43,0,6,73,"-095.4709951","+29.8302031"
"2144","482015315001","48",NA,"1",NA,803,277,526,498,461,22,2,12,1,0,28,957,333,624,586,535,28,2,13,1,7,38,"-095.4689365","+29.8363631"
"2145","482015315002","48",NA,"2",NA,515,191,324,316,296,5,0,15,0,0,8,624,259,365,354,330,5,0,19,0,0,11,"-095.4761021","+29.8349848"
"2146","482015315003","48",NA,"3",NA,1201,415,786,768,486,254,0,23,1,4,18,1469,537,932,909,543,335,0,25,1,5,23,"-095.4820616","+29.8378259"
"2147","482015316001","48",NA,"1",NA,1239,214,1025,989,905,40,5,28,2,9,36,1591,297,1294,1231,1129,44,5,33,2,18,63,"-095.4491387","+29.8377569"
"2148","482015316002","48",NA,"2",NA,1130,483,647,615,522,59,1,29,0,4,32,1416,667,749,702,598,65,1,32,0,6,47,"-095.4615158","+29.8366994"
"2149","482015317001","48",NA,"1",NA,1086,163,923,881,801,24,5,47,0,4,42,1524,243,1281,1192,1085,35,5,62,0,5,89,"-095.4367460","+29.8383764"
"2150","482015317002","48",NA,"2",NA,1359,244,1115,1065,951,20,3,88,1,2,50,1992,383,1609,1485,1321,30,7,121,1,5,124,"-095.4344597","+29.8323408"
"2151","482015318001","48",NA,"1",NA,2002,542,1460,1413,114,1271,3,13,2,10,47,2709,839,1870,1795,152,1610,3,15,2,13,75,"-095.4363437","+29.8534594"
"2152","482015319001","48",NA,"1",NA,1399,420,979,953,75,846,0,26,0,6,26,1946,623,1323,1294,98,1159,0,30,0,7,29,"-095.4509323","+29.8458280"
"2153","482015319002","48",NA,"2",NA,1069,446,623,609,27,575,1,2,0,4,14,1443,650,793,771,35,712,1,9,0,14,22,"-095.4485511","+29.8585414"
"2154","482015319003","48",NA,"3",NA,1321,364,957,928,70,838,0,16,0,4,29,1763,564,1199,1153,81,1038,0,17,0,17,46,"-095.4566771","+29.8552828"
"2155","482015320031","48",NA,"1",NA,1152,750,402,393,49,322,0,14,0,8,9,1638,1112,526,513,62,423,0,17,0,11,13,"-095.4754001","+29.8599789"
"2156","482015320032","48",NA,"2",NA,1090,471,619,590,197,355,0,35,0,3,29,1416,654,762,723,221,457,0,39,0,6,39,"-095.4682756","+29.8596111"
"2157","482015320041","48",NA,"1",NA,806,678,128,123,42,81,0,0,0,0,5,1170,1006,164,156,57,98,0,0,0,1,8,"-095.4652169","+29.8559602"
"2158","482015320042","48",NA,"2",NA,811,373,438,421,127,278,1,15,0,0,17,1100,611,489,466,160,289,1,15,0,1,23,"-095.4690484","+29.8522333"
"2159","482015320043","48",NA,"3",NA,1250,572,678,666,82,571,0,13,0,0,12,1801,915,886,873,99,761,0,13,0,0,13,"-095.4710678","+29.8559014"
"2160","482015320044","48",NA,"4",NA,873,309,564,528,390,119,9,9,1,0,36,1124,443,681,630,464,140,9,9,1,7,51,"-095.4629524","+29.8443098"
"2161","482015321011","48",NA,"1",NA,679,528,151,143,34,98,2,6,0,3,8,987,789,198,188,38,130,2,14,0,4,10,"-095.4710790","+29.8432114"
"2162","482015321012","48",NA,"2",NA,1146,327,819,786,724,36,1,18,0,7,33,1396,425,971,923,837,56,1,21,0,8,48,"-095.4811958","+29.8447596"
"2163","482015321013","48",NA,"3",NA,906,359,547,536,151,322,1,60,0,2,11,1240,539,701,688,168,456,1,61,0,2,13,"-095.4781003","+29.8420623"
"2164","482015321021","48",NA,"1",NA,1479,1380,99,99,35,54,2,8,0,0,0,2337,2217,120,119,49,56,4,10,0,0,1,"-095.4859837","+29.8468369"
"2165","482015321022","48",NA,"2",NA,503,161,342,332,58,269,3,0,0,2,10,767,252,515,500,77,416,3,2,0,2,15,"-095.4743013","+29.8476314"
"2166","482015322001","48",NA,"1",NA,1204,481,723,711,268,405,1,30,1,6,12,1767,778,989,955,294,603,1,39,1,17,34,"-095.4844214","+29.8569939"
"2167","482015322002","48",NA,"2",NA,1272,1069,203,193,50,138,0,5,0,0,10,2060,1788,272,257,59,188,0,7,0,3,15,"-095.4760197","+29.8517345"
"2168","482015323011","48",NA,"1",NA,629,266,363,357,60,273,0,20,0,4,6,847,378,469,462,70,367,0,21,0,4,7,"-095.5086332","+29.8633718"
"2169","482015323012","48",NA,"2",NA,1033,471,562,538,180,301,5,49,0,3,24,1392,683,709,673,201,400,8,61,0,3,36,"-095.5129694","+29.8587372"
"2170","482015323013","48",NA,"3",NA,588,218,370,364,89,254,0,13,3,5,6,749,303,446,439,98,317,0,13,3,8,7,"-095.5077600","+29.8601240"
"2171","482015323021","48",NA,"1",NA,1006,440,566,541,434,68,4,33,0,2,25,1274,620,654,620,481,93,5,39,0,2,34,"-095.4956613","+29.8547163"
"2172","482015323022","48",NA,"2",NA,873,308,565,543,127,381,1,34,0,0,22,1220,473,747,714,139,537,1,37,0,0,33,"-095.5026277","+29.8532107"
"2173","482015323023","48",NA,"3",NA,752,236,516,492,160,268,0,64,0,0,24,982,330,652,616,187,355,0,70,0,4,36,"-095.5028177","+29.8606261"
"2174","482015324001","48",NA,"1",NA,1299,1038,261,237,156,69,0,7,0,5,24,1778,1470,308,275,176,82,0,10,0,7,33,"-095.4860546","+29.8708166"
"2175","482015324002","48",NA,"2",NA,2032,1219,813,783,533,131,2,112,0,5,30,2743,1754,989,936,594,192,2,140,0,8,53,"-095.4955957","+29.8698577"
"2176","482015324003","48",NA,"3",NA,1171,395,776,770,195,491,0,58,0,26,6,1546,535,1011,999,205,709,0,58,0,27,12,"-095.5046102","+29.8697003"
"2177","482015324004","48",NA,"4",NA,704,294,410,384,305,44,1,28,0,6,26,896,418,478,444,337,56,1,41,0,9,34,"-095.5157290","+29.8706165"
"2178","482015325021","48",NA,"1",NA,805,536,269,264,152,96,1,14,0,1,5,1163,829,334,326,168,141,1,15,0,1,8,"-095.4979854","+29.8839871"
"2179","482015325022","48",NA,"2",NA,946,767,179,163,84,31,0,42,0,6,16,1314,1094,220,201,104,47,1,43,0,6,19,"-095.4993547","+29.8926332"
"2180","482015325023","48",NA,"3",NA,2057,1698,359,337,173,121,4,26,0,13,22,2822,2390,432,401,189,161,6,28,0,17,31,"-095.5049055","+29.8782605"
"2181","482015325031","48",NA,"1",NA,1885,894,991,980,211,189,4,573,0,3,11,2548,1279,1269,1246,243,252,4,739,0,8,23,"-095.5179390","+29.8933089"
"2182","482015325032","48",NA,"2",NA,2011,1159,852,819,461,140,10,197,1,10,33,2658,1629,1029,977,518,191,10,238,1,19,52,"-095.5190797","+29.8875654"
"2183","482015325041","48",NA,"1",NA,1660,1125,535,516,289,92,3,132,0,0,19,2230,1594,636,613,325,122,3,159,0,4,23,"-095.5163683","+29.8789697"
"2184","482015325042","48",NA,"2",NA,1825,1132,693,681,163,143,1,367,1,6,12,2486,1595,891,872,208,192,1,463,1,7,19,"-095.5084176","+29.8940267"
"2185","482015326001","48",NA,"1",NA,1095,552,543,538,69,287,2,173,0,7,5,1439,761,678,671,94,364,2,197,0,14,7,"-095.4892092","+29.8916191"
"2186","482015326002","48",NA,"2",NA,1066,554,512,508,107,384,1,14,0,2,4,1407,803,604,594,110,466,2,14,0,2,10,"-095.4895323","+29.8872659"
"2187","482015326003","48",NA,"3",NA,825,413,412,405,90,256,4,51,0,4,7,1114,617,497,479,99,307,4,64,0,5,18,"-095.4812409","+29.8877544"
"2188","482015326004","48",NA,"4",NA,695,437,258,256,29,212,0,15,0,0,2,1069,714,355,353,29,308,0,15,0,1,2,"-095.4761962","+29.8860390"
"2189","482015326005","48",NA,"5",NA,1134,402,732,722,58,415,0,245,0,4,10,1454,573,881,865,63,510,0,288,0,4,16,"-095.4869909","+29.8971490"
"2190","482015327001","48",NA,"1",NA,1402,498,904,884,282,555,0,41,1,5,20,1801,727,1074,1048,317,679,1,42,1,8,26,"-095.4765306","+29.8817025"
"2191","482015327002","48",NA,"2",NA,1226,589,637,615,167,401,6,34,1,6,22,1649,846,803,766,189,525,6,39,1,6,37,"-095.4850549","+29.8774692"
"2192","482015327003","48",NA,"3",NA,1185,448,737,714,172,520,4,10,0,8,23,1637,651,986,949,190,736,4,10,0,9,37,"-095.4795436","+29.8731826"
"2193","482015328001","48",NA,"1",NA,1414,757,657,634,281,299,5,47,0,2,23,1893,1086,807,770,310,392,5,56,0,7,37,"-095.4714738","+29.8714664"
"2194","482015329001","48",NA,"1",NA,808,395,413,407,58,333,10,4,2,0,6,1126,554,572,560,68,472,12,4,2,2,12,"-095.4688443","+29.8894169"
"2195","482015329002","48",NA,"2",NA,1335,736,599,578,77,423,0,76,0,2,21,1750,1046,704,679,84,505,2,82,0,6,25,"-095.4720730","+29.8881161"
"2196","482015329003","48",NA,"3",NA,1812,777,1035,1008,68,780,1,157,0,2,27,2421,1189,1232,1196,83,942,1,167,0,3,36,"-095.4749333","+29.8955013"
"2197","482015330001","48",NA,"1",NA,1854,399,1455,1407,53,1314,2,30,2,6,48,2715,673,2042,1989,76,1861,2,38,2,10,53,"-095.4617414","+29.8895099"
"2198","482015331001","48",NA,"1",NA,1553,673,880,852,249,556,6,33,2,6,28,2197,1026,1171,1136,281,799,7,36,2,11,35,"-095.4647652","+29.8750988"
"2199","482015331002","48",NA,"2",NA,1587,323,1264,1244,42,1190,5,6,0,1,20,2469,533,1936,1907,62,1826,7,10,0,2,29,"-095.4480801","+29.8769683"
"2200","482015331003","48",NA,"3",NA,1695,703,992,971,125,808,1,27,0,10,21,2253,1010,1243,1204,147,1010,3,30,0,14,39,"-095.4563662","+29.8764494"
"2201","482015332001","48",NA,"1",NA,813,199,614,601,12,578,2,4,2,3,13,1101,315,786,770,14,742,3,6,2,3,16,"-095.4406248","+29.8668142"
"2202","482015332002","48",NA,"2",NA,1231,446,785,774,50,702,3,16,0,3,11,1724,713,1011,992,70,893,5,17,0,7,19,"-095.4539815","+29.8670101"
"2203","482015332003","48",NA,"3",NA,519,425,94,89,14,72,1,1,0,1,5,791,687,104,98,16,77,2,2,0,1,6,"-095.4616882","+29.8646909"
"2204","482015332004","48",NA,"4",NA,458,71,387,368,106,231,1,23,1,6,19,532,89,443,416,114,267,3,24,1,7,27,"-095.4635394","+29.8675406"
"2205","482015333011","48",NA,"1",NA,1445,372,1073,1064,20,1039,2,0,0,3,9,2092,526,1566,1549,20,1522,2,0,0,5,17,"-095.4161652","+29.8739705"
"2206","482015333012","48",NA,"2",NA,528,158,370,359,1,356,1,0,0,1,11,671,226,445,430,5,423,1,0,0,1,15,"-095.4251660","+29.8678524"
"2207","482015333021","48",NA,"1",NA,402,17,385,379,0,346,0,30,0,3,6,639,21,618,612,0,576,0,33,0,3,6,"-095.4222992","+29.8867192"
"2208","482015333022","48",NA,"2",NA,1385,514,871,841,26,803,1,7,1,3,30,1818,744,1074,1037,29,985,7,10,1,5,37,"-095.4247923","+29.8824640"
"2209","482015333023","48",NA,"3",NA,828,189,639,620,29,580,0,1,2,8,19,1057,281,776,752,33,697,1,5,2,14,24,"-095.4253389","+29.8746901"
"2210","482015334011","48",NA,"1",NA,1517,979,538,528,33,440,1,48,0,6,10,2017,1392,625,611,48,506,1,50,0,6,14,"-095.4354953","+29.8889161"
"2211","482015334012","48",NA,"2",NA,1501,813,688,670,48,608,1,10,0,3,18,2036,1179,857,838,68,755,1,11,0,3,19,"-095.4284811","+29.8915856"
"2212","482015334013","48",NA,"3",NA,870,532,338,326,44,267,2,13,0,0,12,1215,787,428,411,58,333,2,18,0,0,17,"-095.4370901","+29.8941440"
"2213","482015334021","48",NA,"1",NA,1251,253,998,976,16,949,0,0,3,8,22,1678,410,1268,1237,28,1198,0,0,3,8,31,"-095.4367053","+29.8780786"
"2214","482015334022","48",NA,"2",NA,2948,1900,1048,1023,119,769,0,132,1,2,25,4555,3009,1546,1507,145,1187,0,166,1,8,39,"-095.4510427","+29.8934100"
"2215","482015335001","48",NA,"1",NA,1536,1104,432,421,148,197,2,74,0,0,11,2043,1542,501,489,167,236,2,83,0,1,12,"-095.4162609","+29.8872988"
"2216","482015335002","48",NA,"2",NA,1037,800,237,230,110,84,0,36,0,0,7,1439,1175,264,254,124,88,0,39,0,3,10,"-095.4232007","+29.8991152"
"2217","482015335003","48",NA,"3",NA,667,551,116,116,41,66,1,7,0,1,0,876,744,132,132,45,76,1,9,0,1,0,"-095.4246068","+29.8952485"
"2218","482015336001","48",NA,"1",NA,631,451,180,170,44,92,0,34,0,0,10,838,618,220,207,53,109,3,41,0,1,13,"-095.4189306","+29.9066276"
"2219","482015336002","48",NA,"2",NA,1408,760,648,636,92,514,1,23,0,6,12,1977,1141,836,816,99,681,1,28,0,7,20,"-095.4277745","+29.9071009"
"2220","482015336003","48",NA,"3",NA,1819,1219,600,577,114,409,0,47,0,7,23,2665,1881,784,751,128,561,0,53,0,9,33,"-095.4269190","+29.9111937"
"2221","482015337011","48",NA,"1",NA,1083,691,392,386,29,343,1,12,0,1,6,1796,1116,680,668,45,607,1,13,0,2,12,"-095.4238983","+29.9219819"
"2222","482015337012","48",NA,"2",NA,1520,1196,324,298,66,170,1,55,1,5,26,2057,1660,397,366,72,213,3,68,1,9,31,"-095.4439292","+29.9237887"
"2223","482015337013","48",NA,"3",NA,1381,1021,360,341,60,257,5,12,0,7,19,2032,1510,522,499,76,381,8,21,0,13,23,"-095.4431016","+29.9305135"
"2224","482015337021","48",NA,"1",NA,711,573,138,132,41,59,0,31,0,1,6,943,772,171,165,51,74,2,37,0,1,6,"-095.4362470","+29.9214685"
"2225","482015337022","48",NA,"2",NA,1721,1426,295,282,97,125,4,54,1,1,13,2408,2034,374,356,116,167,9,62,1,1,18,"-095.4383429","+29.9177130"
"2226","482015338021","48",NA,"1",NA,1021,739,282,282,142,86,2,51,0,1,0,1530,1185,345,334,164,111,2,52,0,5,11,"-095.4759957","+29.9217799"
"2227","482015338022","48",NA,"2",NA,1239,925,314,300,58,194,0,44,0,4,14,1750,1340,410,387,74,254,2,53,0,4,23,"-095.4554099","+29.9268343"
"2228","482015338023","48",NA,"3",NA,1665,894,771,768,68,227,0,471,0,2,3,2401,1428,973,966,76,305,0,582,0,3,7,"-095.4629590","+29.9286358"
"2229","482015338024","48",NA,"4",NA,1170,823,347,335,87,88,0,157,0,3,12,1600,1197,403,386,92,105,2,181,0,6,17,"-095.4725906","+29.9314444"
"2230","482015338031","48",NA,"1",NA,3030,1616,1414,1390,153,807,0,426,0,4,24,4384,2492,1892,1855,199,1111,0,535,0,10,37,"-095.4572703","+29.9044116"
"2231","482015338032","48",NA,"2",NA,1535,1298,237,230,92,44,8,72,2,12,7,2255,1961,294,283,102,56,8,100,2,15,11,"-095.4457818","+29.9041210"
"2232","482015338041","48",NA,"1",NA,1994,974,1020,1005,44,640,0,321,0,0,15,2834,1413,1421,1403,72,937,0,394,0,0,18,"-095.4669046","+29.9090689"
"2233","482015338042","48",NA,"2",NA,1392,978,414,405,20,161,0,224,0,0,9,1869,1368,501,486,30,205,0,251,0,0,15,"-095.4450308","+29.9133254"
"2234","482015339021","48",NA,"1",NA,973,441,532,523,26,416,0,78,0,3,9,1437,676,761,752,28,633,0,85,1,5,9,"-095.4951750","+29.9279456"
"2235","482015339022","48",NA,"2",NA,821,499,322,310,46,184,2,74,0,4,12,1135,704,431,416,49,262,6,95,0,4,15,"-095.5040717","+29.9328991"
"2236","482015339023","48",NA,"3",NA,1742,875,867,848,80,698,0,63,0,7,19,2587,1386,1201,1176,89,1007,0,73,0,7,25,"-095.4967644","+29.9241596"
"2237","482015339031","48",NA,"1",NA,1373,842,531,520,41,325,0,149,0,5,11,1914,1218,696,685,51,440,0,184,0,10,11,"-095.4860964","+29.9177899"
"2238","482015339032","48",NA,"2",NA,1982,1089,893,876,185,505,5,179,0,2,17,2672,1610,1062,1029,208,605,5,207,0,4,33,"-095.4861805","+29.9251269"
"2239","482015339041","48",NA,"1",NA,2169,1261,908,894,162,611,4,109,6,2,14,2912,1807,1105,1082,178,769,5,122,6,2,23,"-095.4878662","+29.9338477"
"2240","482015339042","48",NA,"2",NA,1179,740,439,430,99,231,10,87,0,3,9,1631,1093,538,521,116,296,10,90,0,9,17,"-095.4931079","+29.9323620"
"2241","482015340011","48",NA,"1",NA,1380,653,727,723,87,214,1,419,2,0,4,1876,956,920,916,105,279,1,524,2,5,4,"-095.4824252","+29.9096653"
"2242","482015340012","48",NA,"2",NA,1135,842,293,280,131,24,2,119,2,2,13,1617,1265,352,335,156,39,2,133,3,2,17,"-095.4884147","+29.9046705"
"2243","482015340021","48",NA,"1",NA,1812,1305,507,489,156,232,2,89,1,9,18,2491,1876,615,594,176,294,2,105,4,13,21,"-095.5019924","+29.9116222"
"2244","482015340022","48",NA,"2",NA,1062,827,235,223,78,122,1,22,0,0,12,1435,1154,281,264,87,146,4,27,0,0,17,"-095.5045422","+29.9169305"
"2245","482015340023","48",NA,"3",NA,1220,861,359,353,107,190,5,45,1,5,6,1727,1276,451,441,125,245,7,53,2,9,10,"-095.5102880","+29.9209964"
"2246","482015340031","48",NA,"1",NA,1920,1101,819,805,88,394,1,312,1,9,14,2710,1637,1073,1057,108,559,1,379,1,9,16,"-095.5124368","+29.9301640"
"2247","482015341011","48",NA,"1",NA,1434,434,1000,983,120,226,0,621,0,16,17,1956,640,1316,1282,160,290,0,815,0,17,34,"-095.5289969","+29.9308926"
"2248","482015341012","48",NA,"2",NA,705,305,400,378,222,35,0,118,3,0,22,953,465,488,453,256,43,0,151,3,0,35,"-095.5334824","+29.9139557"
"2249","482015341021","48",NA,"1",NA,1749,1245,504,488,190,168,0,119,0,11,16,2482,1869,613,586,215,220,4,127,0,20,27,"-095.5115352","+29.9122939"
"2250","482015341022","48",NA,"2",NA,1842,1166,676,655,261,233,0,161,0,0,21,2478,1659,819,783,285,308,2,183,0,5,36,"-095.5165311","+29.9020836"
"2251","482015342011","48",NA,"1",NA,2178,1391,787,766,252,150,2,352,8,2,21,3035,2018,1017,977,304,211,2,449,9,2,40,"-095.5480759","+29.9127214"
"2252","482015342031","48",NA,"1",NA,1471,886,585,571,261,131,5,166,0,8,14,2067,1350,717,695,314,159,8,205,0,9,22,"-095.5368807","+29.8730007"
"2253","482015342041","48",NA,"1",NA,903,251,652,618,331,173,0,107,0,7,34,1290,370,920,878,437,306,1,127,0,7,42,"-095.5393700","+29.8869857"
"2254","482015342042","48",NA,"2",NA,900,297,603,590,317,223,0,48,0,2,13,1142,404,738,721,361,306,1,51,0,2,17,"-095.5445170","+29.8847137"
"2255","482015342043","48",NA,"3",NA,1344,489,855,818,599,43,0,176,0,0,37,1788,770,1018,962,676,52,9,225,0,0,56,"-095.5280307","+29.8837997"
"2256","482015342044","48",NA,"4",NA,893,258,635,617,365,162,0,90,0,0,18,1082,360,722,702,392,201,0,109,0,0,20,"-095.5452673","+29.8885629"
"2257","482015342051","48",NA,"1",NA,1987,543,1444,1386,855,154,6,368,0,3,58,2462,739,1723,1637,1008,191,8,422,0,8,86,"-095.5440917","+29.8964019"
"2258","482015342052","48",NA,"2",NA,1710,470,1240,1191,943,95,3,141,0,9,49,2129,691,1438,1378,1072,120,3,172,0,11,60,"-095.5314687","+29.8916810"
"2259","482015401011","48",NA,"1",NA,1642,315,1327,1278,691,107,0,468,0,12,49,2095,440,1655,1570,850,133,3,567,1,16,85,"-095.6014057","+29.8566965"
"2260","482015401012","48",NA,"2",NA,1812,195,1617,1570,974,67,2,517,0,10,47,2436,295,2141,2050,1302,96,2,635,0,15,91,"-095.5893881","+29.8580429"
"2261","482015401013","48",NA,"3",NA,1759,400,1359,1300,995,53,0,249,0,3,59,2259,567,1692,1593,1223,64,1,292,2,11,99,"-095.5843055","+29.8411388"
"2262","482015401021","48",NA,"1",NA,1923,1523,400,380,216,95,2,67,0,0,20,2700,2210,490,466,249,118,2,85,0,12,24,"-095.5725484","+29.8632982"
"2263","482015401022","48",NA,"2",NA,852,221,631,614,283,90,4,224,0,13,17,1106,315,791,760,331,128,4,282,0,15,31,"-095.5937618","+29.8738484"
"2264","482015401023","48",NA,"3",NA,1144,180,964,934,227,95,1,605,0,6,30,1490,246,1244,1206,278,118,1,797,0,12,38,"-095.6027286","+29.8674495"
"2265","482015402001","48",NA,"1",NA,1953,1067,886,864,499,181,2,179,0,3,22,2438,1374,1064,1027,586,230,2,203,0,6,37,"-095.5697134","+29.8233580"
"2266","482015405021","48",NA,"1",NA,1234,588,646,614,417,137,4,47,3,6,32,1706,865,841,784,490,209,10,64,3,8,57,"-095.6341154","+29.8527569"
"2267","482015405022","48",NA,"2",NA,1551,653,898,865,676,128,2,50,0,9,33,2096,974,1122,1069,793,211,2,51,0,12,53,"-095.6288578","+29.8453859"
"2268","482015405023","48",NA,"3",NA,1229,427,802,764,605,89,5,56,0,9,38,1615,627,988,923,705,138,7,64,0,9,65,"-095.6372857","+29.8488405"
"2269","482015405031","48",NA,"1",NA,901,639,262,245,86,141,1,17,0,0,17,1318,953,365,345,108,202,1,24,0,10,20,"-095.6392541","+29.8599737"
"2270","482015405032","48",NA,"2",NA,882,595,287,268,85,160,0,19,0,4,19,1276,879,397,365,103,230,0,22,0,10,32,"-095.6433007","+29.8589732"
"2271","482015405041","48",NA,"1",NA,1733,981,752,707,357,251,10,79,0,10,45,2380,1412,968,902,446,339,10,89,0,18,66,"-095.6432044","+29.8441791"
"2272","482015405042","48",NA,"2",NA,753,429,324,309,133,149,0,25,0,2,15,1052,618,434,417,174,211,0,25,0,7,17,"-095.6426648","+29.8544286"
"2273","482015406011","48",NA,"1",NA,3490,1390,2100,2034,1035,496,11,462,2,28,66,4626,1989,2637,2541,1216,707,11,562,6,39,96,"-095.6324332","+29.8621970"
"2274","482015406021","48",NA,"1",NA,1360,732,628,610,183,307,6,106,2,6,18,1917,1086,831,791,217,437,6,122,2,7,40,"-095.6409367","+29.8757500"
"2275","482015406022","48",NA,"2",NA,644,335,309,293,183,52,0,56,0,2,16,850,468,382,360,209,72,0,72,0,7,22,"-095.6356546","+29.8700593"
"2276","482015406023","48",NA,"3",NA,1757,712,1045,1007,462,240,1,287,1,16,38,2298,1006,1292,1225,545,309,1,348,1,21,67,"-095.6307953","+29.8717452"
"2277","482015406024","48",NA,"4",NA,1482,805,677,660,272,228,6,152,0,2,17,2132,1219,913,889,348,337,6,191,0,7,24,"-095.6382678","+29.8709011"
"2278","482015407001","48",NA,"1",NA,1429,294,1135,1081,685,96,6,291,0,3,54,1810,427,1383,1304,836,132,6,324,0,6,79,"-095.6192304","+29.8404169"
"2279","482015407002","48",NA,"2",NA,1621,759,862,827,510,146,0,160,0,11,35,2094,1038,1056,1001,596,199,5,190,0,11,55,"-095.6158139","+29.8580991"
"2280","482015407003","48",NA,"3",NA,1093,543,550,522,265,94,0,161,0,2,28,1406,759,647,610,288,129,4,184,0,5,37,"-095.6145665","+29.8615875"
"2281","482015407004","48",NA,"4",NA,1435,867,568,552,188,67,0,296,0,1,16,2005,1311,694,674,231,92,1,349,0,1,20,"-095.6171762","+29.8701751"
"2282","482015408001","48",NA,"1",NA,1728,1239,489,457,215,136,5,97,0,4,32,2342,1743,599,549,238,183,5,116,1,6,50,"-095.6133463","+29.8882537"
"2283","482015408002","48",NA,"2",NA,1702,1078,624,578,288,139,2,133,1,15,46,2246,1470,776,693,337,177,3,157,2,17,83,"-095.6144074","+29.8828979"
"2284","482015408003","48",NA,"3",NA,1502,546,956,927,418,250,4,254,0,1,29,1887,708,1179,1145,494,330,4,316,0,1,34,"-095.6133385","+29.8999870"
"2285","482015408004","48",NA,"4",NA,899,400,499,473,195,200,2,74,0,2,26,1194,582,612,572,233,243,5,84,0,7,40,"-095.5917997","+29.8868277"
"2286","482015409011","48",NA,"1",NA,2312,400,1912,1827,1321,320,7,177,0,2,85,2810,554,2256,2139,1516,403,8,204,1,7,117,"-095.6244446","+29.8894857"
"2287","482015409031","48",NA,"1",NA,808,218,590,567,182,337,0,48,0,0,23,993,260,733,706,209,437,0,60,0,0,27,"-095.6239529","+29.9093429"
"2288","482015409032","48",NA,"2",NA,1378,392,986,930,362,343,0,215,0,10,56,1820,541,1279,1199,448,472,0,266,0,13,80,"-095.6267452","+29.9033544"
"2289","482015409041","48",NA,"1",NA,2022,378,1644,1578,1242,177,4,150,1,4,66,2477,547,1930,1834,1422,213,4,187,1,7,96,"-095.6337961","+29.8896332"
"2290","482015409042","48",NA,"2",NA,806,278,528,502,278,143,1,67,4,9,26,1040,378,662,622,334,195,1,77,4,11,40,"-095.6331896","+29.8958962"
"2291","482015409043","48",NA,"3",NA,1202,429,773,763,295,388,0,79,1,0,10,1543,580,963,947,330,528,0,88,1,0,16,"-095.6322681","+29.8986870"
"2292","482015410041","48",NA,"1",NA,1731,417,1314,1285,836,220,1,221,0,7,29,2224,573,1651,1594,996,313,1,277,0,7,57,"-095.6441615","+29.9102645"
"2293","482015410042","48",NA,"2",NA,1127,267,860,821,308,268,12,228,0,5,39,1487,369,1118,1062,390,379,18,268,0,7,56,"-095.6379519","+29.9132810"
"2294","482015410043","48",NA,"3",NA,1807,472,1335,1295,236,384,0,661,0,14,40,2525,699,1826,1764,300,580,0,859,1,24,62,"-095.6403960","+29.9232994"
"2295","482015410051","48",NA,"1",NA,1817,513,1304,1243,478,582,0,170,1,12,61,2410,745,1665,1580,602,762,2,200,1,13,85,"-095.6283098","+29.9138909"
"2296","482015410052","48",NA,"2",NA,870,281,589,570,164,378,0,25,0,3,19,1169,410,759,733,194,506,0,30,0,3,26,"-095.6367147","+29.9071454"
"2297","482015410053","48",NA,"3",NA,977,361,616,573,267,253,1,46,2,4,43,1309,507,802,743,331,347,1,58,2,4,59,"-095.6359910","+29.9050515"
"2298","482015410061","48",NA,"1",NA,1273,306,967,928,590,174,2,147,0,15,39,1751,471,1280,1214,762,238,2,188,0,24,66,"-095.6767715","+29.9288758"
"2299","482015410062","48",NA,"2",NA,2095,584,1511,1451,794,283,8,346,0,20,60,2913,853,2060,1969,1082,397,9,453,0,28,91,"-095.6825481","+29.9222952"
"2300","482015410063","48",NA,"3",NA,911,243,668,640,346,133,1,158,1,1,28,1235,362,873,839,435,191,1,208,1,3,34,"-095.6780313","+29.9340818"
"2301","482015410071","48",NA,"1",NA,1265,311,954,927,427,227,2,270,0,1,27,1779,465,1314,1250,560,318,2,363,0,7,64,"-095.6807963","+29.9161918"
"2302","482015410072","48",NA,"2",NA,1622,345,1277,1234,599,319,8,302,0,6,43,2225,481,1744,1666,790,460,8,398,0,10,78,"-095.6798755","+29.9111562"
"2303","482015410073","48",NA,"3",NA,1569,299,1270,1210,771,193,2,232,0,12,60,2148,466,1682,1577,1014,247,2,296,0,18,105,"-095.6724194","+29.9388159"
"2304","482015410074","48",NA,"4",NA,990,219,771,758,338,190,4,223,0,3,13,1377,317,1060,1035,476,260,4,288,0,7,25,"-095.6690210","+29.9277370"
"2305","482015410081","48",NA,"1",NA,1473,269,1204,1157,665,187,3,297,0,5,47,2016,396,1620,1528,863,259,3,398,0,5,92,"-095.6566218","+29.9245170"
"2306","482015410082","48",NA,"2",NA,1318,214,1104,1069,556,203,0,303,1,6,35,1855,329,1526,1467,753,289,0,415,1,9,59,"-095.6634250","+29.9260962"
"2307","482015410091","48",NA,"1",NA,2075,509,1566,1490,746,373,3,357,3,8,76,2928,771,2157,2009,978,522,6,481,3,19,148,"-095.6637317","+29.9105352"
"2308","482015410092","48",NA,"2",NA,1828,604,1224,1162,677,304,1,179,1,0,62,2539,902,1637,1545,868,432,2,233,1,9,92,"-095.6554880","+29.9138352"
"2309","482015411001","48",NA,"1",NA,1659,457,1202,1154,968,120,3,54,0,9,48,2133,676,1457,1384,1149,153,3,66,0,13,73,"-095.6431018","+29.8981471"
"2310","482015411002","48",NA,"2",NA,1807,365,1442,1369,971,205,2,180,0,11,73,2292,536,1756,1657,1150,277,2,214,0,14,99,"-095.6618141","+29.9014500"
"2311","482015411003","48",NA,"3",NA,1770,492,1278,1227,972,160,7,88,0,0,51,2294,712,1582,1511,1194,197,10,110,0,0,71,"-095.6515284","+29.9039377"
"2312","482015412031","48",NA,"1",NA,1001,160,841,807,692,45,0,66,0,4,34,1192,232,960,917,790,55,0,68,0,4,43,"-095.6471787","+29.8854250"
"2313","482015412032","48",NA,"2",NA,1137,211,926,890,753,67,0,68,0,2,36,1415,299,1116,1053,882,83,0,86,0,2,63,"-095.6510289","+29.8923632"
"2314","482015412041","48",NA,"1",NA,1764,1023,741,708,445,163,8,86,0,6,33,2356,1413,943,888,548,219,9,102,0,10,55,"-095.6595464","+29.8819329"
"2315","482015412042","48",NA,"2",NA,1792,865,927,895,580,238,2,72,3,0,32,2445,1258,1187,1131,733,306,4,80,4,4,56,"-095.6542426","+29.8842746"
"2316","482015412043","48",NA,"3",NA,668,259,409,398,292,65,1,36,1,3,11,875,372,503,476,342,90,1,38,1,4,27,"-095.6666067","+29.8853844"
"2317","482015412051","48",NA,"1",NA,1642,416,1226,1169,890,140,0,136,1,2,57,2177,632,1545,1447,1091,193,2,155,1,5,98,"-095.6638438","+29.8953240"
"2318","482015412052","48",NA,"2",NA,734,194,540,513,425,58,3,23,0,4,27,991,288,703,649,528,84,3,29,0,5,54,"-095.6585858","+29.8910135"
"2319","482015412061","48",NA,"1",NA,1710,490,1220,1171,673,212,4,274,3,5,49,2251,728,1523,1447,793,265,4,372,3,10,76,"-095.6717002","+29.8845050"
"2320","482015412062","48",NA,"2",NA,1768,443,1325,1274,871,281,5,106,0,11,51,2352,671,1681,1609,1057,384,5,143,0,20,72,"-095.6795880","+29.8875564"
"2321","482015412071","48",NA,"1",NA,1416,273,1143,1088,912,105,2,61,0,8,55,1788,391,1397,1321,1089,140,2,76,0,14,76,"-095.6712554","+29.8948112"
"2322","482015412072","48",NA,"2",NA,2040,400,1640,1579,1020,215,1,333,0,10,61,2682,588,2094,1994,1254,305,1,419,0,15,100,"-095.6764308","+29.9020348"
"2323","482015413011","48",NA,"1",NA,1204,550,654,629,287,228,8,105,0,1,25,1637,786,851,791,329,305,8,146,0,3,60,"-095.6662053","+29.8742602"
"2324","482015413012","48",NA,"2",NA,1151,501,650,628,259,223,3,134,0,9,22,1588,725,863,825,316,307,10,180,0,12,38,"-095.6589136","+29.8691232"
"2325","482015413013","48",NA,"3",NA,2485,1085,1400,1339,361,573,2,381,2,20,61,3385,1581,1804,1709,437,780,4,454,2,32,95,"-095.6528696","+29.8719383"
"2326","482015413021","48",NA,"1",NA,594,448,146,139,76,43,2,15,0,3,7,828,646,182,173,97,53,2,18,0,3,9,"-095.6814162","+29.8683953"
"2327","482015413022","48",NA,"2",NA,861,499,362,338,142,142,3,50,0,1,24,1151,710,441,408,154,192,5,53,0,4,33,"-095.6746371","+29.8678858"
"2328","482015413023","48",NA,"3",NA,963,569,394,379,115,104,4,153,0,3,15,1354,852,502,486,149,159,9,166,0,3,16,"-095.6700388","+29.8760058"
"2329","482015413024","48",NA,"4",NA,1397,905,492,467,242,167,0,54,0,4,25,1955,1320,635,607,290,245,0,66,0,6,28,"-095.6765812","+29.8723331"
"2330","482015413025","48",NA,"5",NA,1192,716,476,449,265,135,4,33,4,8,27,1589,989,600,567,321,185,4,42,4,11,33,"-095.6775933","+29.8761668"
"2331","482015414011","48",NA,"1",NA,435,167,268,262,68,133,0,61,0,0,6,519,209,310,303,68,153,0,82,0,0,7,"-095.6472280","+29.8603610"
"2332","482015414012","48",NA,"2",NA,1477,342,1135,1092,250,249,0,579,6,8,43,1973,477,1496,1426,325,334,0,745,6,16,70,"-095.6493531","+29.8540385"
"2333","482015414013","48",NA,"3",NA,1403,385,1018,996,203,244,4,534,4,7,22,1855,541,1314,1272,253,347,4,652,4,12,42,"-095.6531653","+29.8612664"
"2334","482015414021","48",NA,"1",NA,1168,745,423,410,288,85,3,32,0,2,13,1606,1062,544,508,332,124,6,36,0,10,36,"-095.6549804","+29.8532768"
"2335","482015414022","48",NA,"2",NA,1353,814,539,524,267,162,5,84,0,6,15,1795,1136,659,630,298,210,10,102,0,10,29,"-095.6594865","+29.8541656"
"2336","482015414031","48",NA,"1",NA,2025,1083,942,898,321,386,5,181,0,5,44,2834,1548,1286,1216,415,552,5,233,0,11,70,"-095.6651534","+29.8548135"
"2337","482015414041","48",NA,"1",NA,1027,300,727,702,177,356,0,167,1,1,25,1380,419,961,919,225,486,0,206,1,1,42,"-095.6573196","+29.8648667"
"2338","482015414042","48",NA,"2",NA,445,126,319,311,52,202,0,56,1,0,8,622,181,441,430,62,294,0,67,5,2,11,"-095.6479992","+29.8648851"
"2339","482015414043","48",NA,"3",NA,1538,534,1004,972,162,362,7,422,3,16,32,2166,781,1385,1333,230,542,7,532,3,19,52,"-095.6651069","+29.8619859"
"2340","482015415001","48",NA,"1",NA,1970,998,972,925,545,242,5,126,1,6,47,2698,1469,1229,1160,645,342,5,154,1,13,69,"-095.6781053","+29.8532468"
"2341","482015415002","48",NA,"2",NA,2140,817,1323,1263,500,361,4,385,1,12,60,2918,1226,1692,1597,577,504,5,485,1,25,95,"-095.6752578","+29.8596045"
"2342","482015416031","48",NA,"1",NA,1220,822,398,370,189,112,0,52,5,12,28,1649,1144,505,462,224,145,0,69,5,19,43,"-095.6618048","+29.8448535"
"2343","482015416032","48",NA,"2",NA,863,616,247,233,108,36,1,86,0,2,14,1285,951,334,308,134,60,1,107,0,6,26,"-095.6481631","+29.8439621"
"2344","482015416033","48",NA,"3",NA,999,625,374,355,262,62,4,21,1,5,19,1364,921,443,414,295,83,4,26,1,5,29,"-095.6528020","+29.8442347"
"2345","482015416034","48",NA,"4",NA,1229,871,358,339,172,128,0,28,5,6,19,1665,1203,462,422,216,166,0,28,5,7,40,"-095.6511990","+29.8383507"
"2346","482015416035","48",NA,"5",NA,1302,812,490,471,330,113,0,23,2,3,19,1778,1182,596,562,366,154,0,34,4,4,34,"-095.6565023","+29.8423144"
"2347","482015416041","48",NA,"1",NA,1205,154,1051,1006,885,65,0,50,0,6,45,1457,220,1237,1173,1026,85,0,56,0,6,64,"-095.6790766","+29.8437483"
"2348","482015416042","48",NA,"2",NA,993,164,829,792,720,27,0,44,0,1,37,1200,196,1004,947,844,47,0,55,0,1,57,"-095.6795239","+29.8348222"
"2349","482015416043","48",NA,"3",NA,3080,1021,2059,1988,738,628,1,605,4,12,71,4218,1485,2733,2626,912,894,1,789,4,26,107,"-095.6932583","+29.8390075"
"2350","482015416044","48",NA,"4",NA,463,157,306,287,182,23,1,78,0,3,19,608,237,371,340,215,27,1,94,0,3,31,"-095.6638355","+29.8378055"
"2351","482015416045","48",NA,"5",NA,1578,371,1207,1174,511,175,3,481,1,3,33,2071,501,1570,1514,612,271,3,620,1,7,56,"-095.6692993","+29.8401893"
"2352","482015417011","48",NA,"1",NA,1991,915,1076,1018,304,387,4,315,0,8,58,2839,1319,1520,1452,405,598,4,434,0,11,68,"-095.6828167","+29.8166658"
"2353","482015417012","48",NA,"2",NA,781,460,321,301,121,139,0,41,0,0,20,1083,643,440,408,153,208,0,47,0,0,32,"-095.6519697","+29.8329328"
"2354","482015417013","48",NA,"3",NA,1368,540,828,802,326,245,2,219,1,9,26,1880,771,1109,1067,399,360,2,294,1,11,42,"-095.6562593","+29.8204624"
"2355","482015417021","48",NA,"1",NA,1172,337,835,805,252,456,0,92,0,5,30,1524,456,1068,1038,284,634,0,115,0,5,30,"-095.6511959","+29.7869912"
"2356","482015417022","48",NA,"2",NA,739,214,525,498,187,251,0,56,0,4,27,934,301,633,592,205,313,0,69,0,5,41,"-095.6688113","+29.7874536"
"2357","482015417031","48",NA,"1",NA,841,359,482,466,146,275,5,33,1,6,16,1166,510,656,636,184,396,5,44,1,6,20,"-095.6861043","+29.7940498"
"2358","482015417032","48",NA,"2",NA,1320,397,923,875,439,347,1,78,3,7,48,1616,519,1097,1027,491,443,1,82,3,7,70,"-095.6847851","+29.7955529"
"2359","482015417033","48",NA,"3",NA,708,206,502,470,252,95,5,118,0,0,32,851,263,588,542,292,113,5,132,0,0,46,"-095.6649617","+29.8027115"
"2360","482015418011","48",NA,"1",NA,1485,684,801,768,431,272,2,50,0,13,33,1908,914,994,941,511,351,2,62,1,14,53,"-095.7090283","+29.7962100"
"2361","482015418012","48",NA,"2",NA,1322,613,709,664,392,192,6,69,0,5,45,1748,859,889,819,449,281,6,75,0,8,70,"-095.7160747","+29.7950015"
"2362","482015418021","48",NA,"1",NA,1380,428,952,890,426,351,7,97,0,9,62,1764,545,1219,1125,494,484,7,127,0,13,94,"-095.6938226","+29.7970212"
"2363","482015418022","48",NA,"2",NA,1949,883,1066,1034,415,419,6,193,0,1,32,2513,1184,1329,1288,515,520,6,240,0,7,41,"-095.7000975","+29.7918917"
"2364","482015419011","48",NA,"1",NA,2025,693,1332,1277,648,345,3,272,0,9,55,2705,973,1732,1653,782,492,4,364,2,9,79,"-095.6962227","+29.8067448"
"2365","482015419021","48",NA,"1",NA,1082,575,507,482,319,96,4,57,0,6,25,1390,781,609,573,360,129,6,70,0,8,36,"-095.6982359","+29.8257270"
"2366","482015419022","48",NA,"2",NA,2602,843,1759,1677,1036,290,11,331,0,9,82,3494,1188,2306,2196,1308,465,13,393,0,17,110,"-095.6928519","+29.8168763"
"2367","482015420011","48",NA,"1",NA,1830,734,1096,1064,688,269,3,100,2,2,32,2424,1040,1384,1326,841,360,3,115,5,2,58,"-095.7163377","+29.8203451"
"2368","482015420012","48",NA,"2",NA,1649,893,756,705,492,149,0,49,6,9,51,2237,1280,957,881,578,214,0,66,6,17,76,"-095.7074217","+29.8182514"
"2369","482015420021","48",NA,"1",NA,1079,501,578,562,189,244,0,129,0,0,16,1425,674,751,727,251,324,0,151,0,1,24,"-095.7110705","+29.8261567"
"2370","482015420022","48",NA,"2",NA,1221,558,663,637,300,238,2,93,1,3,26,1677,795,882,827,358,348,2,114,2,3,55,"-095.7109399","+29.8279168"
"2371","482015420031","48",NA,"1",NA,1025,315,710,690,270,200,4,212,0,4,20,1375,446,929,899,342,281,4,266,1,5,30,"-095.7161166","+29.8120301"
"2372","482015420032","48",NA,"2",NA,2050,1020,1030,989,360,325,6,281,1,16,41,2940,1493,1447,1371,501,497,6,348,1,18,76,"-095.7082510","+29.8113001"
"2373","482015420041","48",NA,"1",NA,1191,562,629,595,430,126,1,33,0,5,34,1522,758,764,708,486,175,1,40,0,6,56,"-095.7126284","+29.8025739"
"2374","482015420042","48",NA,"2",NA,1233,634,599,570,388,114,1,62,2,3,29,1642,852,790,728,481,160,3,78,2,4,62,"-095.7123905","+29.8064197"
"2375","482015421031","48",NA,"1",NA,2025,1100,925,888,345,459,2,77,0,5,37,3018,1677,1341,1274,440,718,2,101,2,11,67,"-095.7012692","+29.8614934"
"2376","482015421032","48",NA,"2",NA,1852,897,955,896,354,401,1,130,4,6,59,2537,1292,1245,1176,417,582,1,163,4,9,69,"-095.6890063","+29.8613389"
"2377","482015421033","48",NA,"3",NA,3040,1291,1749,1658,262,1290,2,88,1,15,91,4753,1993,2760,2618,364,2087,3,125,5,34,142,"-095.6978731","+29.8525654"
"2378","482015421041","48",NA,"1",NA,1577,1005,572,542,192,273,0,62,4,11,30,2317,1460,857,811,272,429,2,81,4,23,46,"-095.7065337","+29.8408212"
"2379","482015421042","48",NA,"2",NA,1563,1029,534,510,300,155,3,44,1,7,24,2112,1418,694,654,369,204,6,56,5,14,40,"-095.7066563","+29.8345011"
"2380","482015421043","48",NA,"3",NA,2181,1260,921,892,348,367,6,158,3,10,29,3155,1875,1280,1236,441,567,7,206,4,11,44,"-095.7149270","+29.8369625"
"2381","482015421051","48",NA,"1",NA,1812,857,955,897,357,352,7,162,4,15,58,2548,1281,1267,1173,437,497,10,202,4,23,94,"-095.7125786","+29.8483313"
"2382","482015421052","48",NA,"2",NA,2257,1007,1250,1214,291,711,2,191,3,16,36,3280,1521,1759,1698,360,1064,2,241,3,28,61,"-095.7133731","+29.8598223"
"2383","482015421053","48",NA,"3",NA,3060,1314,1746,1684,291,1160,4,211,0,18,62,4678,1967,2711,2598,400,1891,4,278,0,25,113,"-095.7099500","+29.8543208"
"2384","482015421061","48",NA,"1",NA,2359,1026,1333,1270,428,636,15,180,0,11,63,3242,1453,1789,1692,527,921,16,214,0,14,97,"-095.7163815","+29.8741750"
"2385","482015421062","48",NA,"2",NA,1479,799,680,644,385,204,2,53,0,0,36,2060,1127,933,867,467,326,6,66,0,2,66,"-095.7076058","+29.8768500"
"2386","482015421063","48",NA,"3",NA,2471,1255,1216,1162,265,694,3,193,0,7,54,3497,1846,1651,1570,337,991,3,225,0,14,81,"-095.7125314","+29.8669550"
"2387","482015421071","48",NA,"1",NA,1668,837,831,795,435,285,11,60,0,4,36,2281,1227,1054,997,518,390,11,74,0,4,57,"-095.6878219","+29.8745004"
"2388","482015421072","48",NA,"2",NA,1167,583,584,570,131,268,2,151,0,18,14,1657,868,789,766,176,393,2,177,0,18,23,"-095.6879343","+29.8678157"
"2389","482015421081","48",NA,"1",NA,596,254,342,332,38,171,0,120,0,3,10,908,409,499,483,61,257,0,159,0,6,16,"-095.6983776","+29.8677899"
"2390","482015421082","48",NA,"2",NA,733,336,397,386,105,203,0,77,0,1,11,1041,497,544,530,128,295,0,104,0,3,14,"-095.6943026","+29.8679784"
"2391","482015421083","48",NA,"3",NA,583,338,245,236,40,159,0,37,0,0,9,880,513,367,344,51,237,0,49,0,7,23,"-095.6968466","+29.8757415"
"2392","482015421084","48",NA,"4",NA,560,227,333,301,159,97,2,39,2,2,32,739,318,421,370,186,138,2,40,2,2,51,"-095.7025309","+29.8676392"
"2393","482015422011","48",NA,"1",NA,2107,918,1189,1129,424,541,4,147,0,13,60,3021,1385,1636,1532,517,808,9,175,0,23,104,"-095.7246361","+29.8652849"
"2394","482015422012","48",NA,"2",NA,1045,498,547,524,253,199,6,64,0,2,23,1438,730,708,669,312,274,6,75,0,2,39,"-095.7302917","+29.8733310"
"2395","482015422013","48",NA,"3",NA,1846,1074,772,746,192,467,0,80,0,7,26,2740,1609,1131,1088,256,713,1,111,0,7,43,"-095.7254532","+29.8743094"
"2396","482015422021","48",NA,"1",NA,2403,1031,1372,1332,222,741,3,356,0,10,40,3631,1554,2077,2004,335,1172,3,479,0,15,73,"-095.7242846","+29.8385756"
"2397","482015422022","48",NA,"2",NA,4179,1831,2348,2235,794,910,16,484,0,31,113,6136,2717,3419,3220,1071,1437,16,646,0,50,199,"-095.7477262","+29.8524543"
"2398","482015422031","48",NA,"1",NA,2054,1009,1045,994,516,374,9,90,0,5,51,2911,1498,1413,1333,649,538,16,115,0,15,80,"-095.7379834","+29.8735294"
"2399","482015422032","48",NA,"2",NA,1537,689,848,790,432,269,4,72,0,13,58,2117,1008,1109,1020,515,389,9,92,0,15,89,"-095.7238381","+29.8489822"
"2400","482015422033","48",NA,"3",NA,3929,2107,1822,1756,521,888,6,314,0,27,66,5719,3148,2571,2455,689,1306,12,403,0,45,116,"-095.7371666","+29.8583283"
"2401","482015423021","48",NA,"1",NA,1919,819,1100,1050,416,472,3,148,0,11,50,2713,1184,1529,1441,544,672,6,201,0,18,88,"-095.7442577","+29.8092846"
"2402","482015423022","48",NA,"2",NA,1695,773,922,894,335,388,4,149,3,15,28,2419,1126,1293,1243,447,574,8,187,3,24,50,"-095.7498050","+29.8226600"
"2403","482015423023","48",NA,"3",NA,1769,819,950,899,564,229,8,87,1,10,51,2268,1151,1117,1038,622,287,13,104,1,11,79,"-095.7298233","+29.8050235"
"2404","482015423031","48",NA,"1",NA,1484,650,834,789,491,213,11,74,0,0,45,1933,918,1015,954,586,264,11,88,0,5,61,"-095.7244306","+29.8075863"
"2405","482015423032","48",NA,"2",NA,1015,403,612,571,330,117,4,117,0,3,41,1345,571,774,721,393,167,4,149,0,8,53,"-095.7250625","+29.8128534"
"2406","482015423041","48",NA,"1",NA,2397,1454,943,892,511,212,1,148,1,19,51,3424,2201,1223,1140,609,320,1,180,1,29,83,"-095.7251363","+29.8198063"
"2407","482015423042","48",NA,"2",NA,1677,657,1020,978,519,264,5,177,1,12,42,2271,935,1336,1261,647,363,8,222,1,20,75,"-095.7245559","+29.8271363"
"2408","482015423051","48",NA,"1",NA,2553,1151,1402,1336,418,637,2,262,0,17,66,3694,1683,2011,1918,582,962,2,342,0,30,93,"-095.7355420","+29.8240880"
"2409","482015423052","48",NA,"2",NA,1841,848,993,948,495,347,3,95,0,8,45,2551,1202,1349,1252,637,468,3,128,0,16,97,"-095.7444634","+29.8260250"
"2410","482015424011","48",NA,"1",NA,1095,626,469,449,307,88,3,40,1,10,20,1467,858,609,577,382,125,3,52,1,14,32,"-095.7249401","+29.7986633"
"2411","482015424012","48",NA,"2",NA,1214,632,582,557,208,287,2,51,0,9,25,1741,913,828,794,277,432,2,72,0,11,34,"-095.7266350","+29.7935339"
"2412","482015424013","48",NA,"3",NA,1083,517,566,534,207,237,0,85,1,4,32,1474,733,741,697,242,334,1,110,1,9,44,"-095.7232603","+29.7928438"
"2413","482015424021","48",NA,"1",NA,1364,561,803,774,306,258,2,194,0,14,29,1857,786,1071,1021,398,373,2,229,2,17,50,"-095.7409688","+29.7969327"
"2414","482015424022","48",NA,"2",NA,793,420,373,350,200,124,0,25,0,1,23,1084,591,493,458,241,187,0,29,0,1,35,"-095.7459246","+29.7917787"
"2415","482015424023","48",NA,"3",NA,1584,963,621,586,341,197,1,40,0,7,35,2153,1368,785,737,385,276,6,58,1,11,48,"-095.7239233","+29.7884068"
"2416","482015424024","48",NA,"4",NA,1122,685,437,415,211,135,3,57,0,9,22,1441,900,541,516,259,178,3,65,0,11,25,"-095.7333873","+29.7990928"
"2417","482015425001","48",NA,"1",NA,1030,146,884,861,791,46,0,20,0,4,23,1190,191,999,958,881,47,2,24,0,4,41,"-095.7662846","+29.7991024"
"2418","482015425002","48",NA,"2",NA,2187,607,1580,1516,994,319,6,189,1,7,64,2714,778,1936,1833,1199,397,14,215,1,7,103,"-095.7637897","+29.7922306"
"2419","482015426001","48",NA,"1",NA,2426,741,1685,1617,931,424,4,237,2,19,68,3205,1027,2178,2071,1161,558,4,311,3,34,107,"-095.7904563","+29.7920686"
"2420","482015426002","48",NA,"2",NA,1045,504,541,515,370,93,0,46,0,6,26,1407,705,702,659,462,128,0,62,0,7,43,"-095.7819994","+29.7986581"
"2421","482015426003","48",NA,"3",NA,1075,370,705,654,518,90,2,40,0,4,51,1469,526,943,863,676,126,2,52,0,7,80,"-095.7896017","+29.7981587"
"2422","482015427001","48",NA,"1",NA,981,241,740,694,630,38,0,26,0,0,46,1190,319,871,809,733,48,0,28,0,0,62,"-095.8094536","+29.7914967"
"2423","482015427002","48",NA,"2",NA,1542,491,1051,1007,927,66,0,11,0,3,44,1929,649,1280,1217,1116,84,0,13,1,3,63,"-095.8151502","+29.7959337"
"2424","482015427003","48",NA,"3",NA,611,171,440,424,373,28,2,19,0,2,16,834,278,556,536,465,47,2,19,1,2,20,"-095.8240717","+29.7959052"
"2425","482015428001","48",NA,"1",NA,1790,353,1437,1374,1284,51,4,31,0,4,63,2334,545,1789,1682,1558,73,6,36,2,7,107,"-095.8152033","+29.8239522"
"2426","482015428002","48",NA,"2",NA,2314,710,1604,1542,1387,67,10,69,0,9,62,3186,1029,2157,2057,1844,90,13,95,2,13,100,"-095.8232426","+29.8070527"
"2427","482015428003","48",NA,"3",NA,1781,991,790,751,616,95,3,25,0,12,39,2490,1471,1019,937,753,129,3,32,5,15,82,"-095.8170943","+29.8133453"
"2428","482015429011","48",NA,"1",NA,1827,737,1090,1026,837,137,5,37,1,9,64,2431,1080,1351,1248,992,197,8,37,1,13,103,"-095.7647190","+29.8068925"
"2429","482015429012","48",NA,"2",NA,1593,579,1014,983,516,306,2,159,0,0,31,2149,802,1347,1295,652,409,5,228,0,1,52,"-095.7565983","+29.8096053"
"2430","482015429013","48",NA,"3",NA,2980,1201,1779,1710,923,497,3,267,1,19,69,4281,1805,2476,2363,1192,793,5,345,1,27,113,"-095.7598142","+29.8238263"
"2431","482015429014","48",NA,"4",NA,875,285,590,563,403,120,2,34,0,4,27,1219,443,776,737,521,174,2,35,0,5,39,"-095.7694285","+29.8106000"
"2432","482015429021","48",NA,"1",NA,2538,1074,1464,1371,819,374,0,168,0,10,93,3690,1668,2022,1858,1099,532,0,215,0,12,164,"-095.8000473","+29.8119394"
"2433","482015429022","48",NA,"2",NA,13057,4359,8698,8322,4247,2546,40,1405,14,70,376,19522,6889,12633,11890,5792,3918,59,1969,19,133,743,"-095.8058186","+29.8485683"
"2434","482015429023","48",NA,"3",NA,1978,728,1250,1204,721,261,3,212,0,7,46,2755,1073,1682,1606,954,352,3,287,0,10,76,"-095.7848698","+29.8087456"
"2435","482015429024","48",NA,"4",NA,943,408,535,515,321,107,1,83,0,3,20,1253,536,717,683,402,152,1,125,0,3,34,"-095.7875295","+29.8036752"
"2436","482015430041","48",NA,"1",NA,4674,758,3916,3764,2512,348,8,871,2,23,152,7325,1263,6062,5706,3770,543,15,1336,9,33,356,"-095.7521947","+29.9772627"
"2437","482015430042","48",NA,"2",NA,4928,919,4009,3849,2183,568,9,1056,5,28,160,7458,1485,5973,5653,3126,851,17,1593,14,52,320,"-095.7494289","+29.9298758"
"2438","482015430051","48",NA,"1",NA,1701,477,1224,1172,803,265,2,86,0,16,52,2458,718,1740,1656,1109,403,7,120,0,17,84,"-095.7831213","+29.9330158"
"2439","482015430052","48",NA,"2",NA,4300,1586,2714,2611,1016,1211,10,354,2,18,103,6170,2403,3767,3606,1355,1745,10,471,2,23,161,"-095.7260032","+29.8949511"
"2440","482015430061","48",NA,"1",NA,7018,1433,5585,5358,2147,1567,7,1614,4,19,227,10277,2195,8082,7697,2989,2342,14,2312,8,32,385,"-095.7200482","+29.9126054"
"2441","482015430062","48",NA,"2",NA,4818,1100,3718,3589,2019,806,5,724,5,30,129,6489,1634,4855,4616,2415,1151,7,991,5,47,239,"-095.6942285","+29.9129386"
"2442","482015430071","48",NA,"1",NA,2288,353,1935,1846,1485,158,8,190,0,5,89,3233,568,2665,2504,1991,211,9,284,0,9,161,"-095.7110266","+29.9511624"
"2443","482015430072","48",NA,"2",NA,2700,705,1995,1919,640,624,6,646,0,3,76,3924,1063,2861,2719,911,908,9,883,0,8,142,"-095.6821673","+29.9444235"
"2444","482015430073","48",NA,"3",NA,1783,318,1465,1410,889,267,11,227,0,16,55,2400,461,1939,1840,1103,360,18,333,0,26,99,"-095.7038139","+29.9645947"
"2445","482015430074","48",NA,"4",NA,3090,519,2571,2502,1364,347,2,780,0,9,69,4728,863,3865,3710,1971,538,10,1165,0,26,155,"-095.6957774","+29.9357649"
"2446","482015430075","48",NA,"5",NA,4191,661,3530,3385,1840,538,13,971,1,22,145,6245,1045,5200,4897,2607,747,20,1494,1,28,303,"-095.7135481","+29.9367849"
"2447","482015430081","48",NA,"1",NA,1648,587,1061,1007,413,271,3,310,3,7,54,2325,874,1451,1370,523,438,3,389,3,14,81,"-095.6893703","+29.8869772"
"2448","482015430082","48",NA,"2",NA,1673,613,1060,1011,435,321,8,242,0,5,49,2535,969,1566,1468,610,499,12,339,0,8,98,"-095.6881064","+29.8918419"
"2449","482015430083","48",NA,"3",NA,1012,513,499,476,309,102,8,52,0,5,23,1365,736,629,591,366,145,12,61,0,7,38,"-095.6936555","+29.8828393"
"2450","482015430091","48",NA,"1",NA,1306,722,584,562,147,314,0,88,2,11,22,1925,1094,831,795,217,445,0,116,2,15,36,"-095.7004629","+29.8835312"
"2451","482015430092","48",NA,"2",NA,1525,729,796,769,199,436,0,116,3,15,27,2299,1151,1148,1091,257,656,5,150,3,20,57,"-095.7003614","+29.8910929"
"2452","482015430101","48",NA,"1",NA,1684,921,763,724,213,386,3,115,0,7,39,2416,1358,1058,997,280,569,3,138,0,7,61,"-095.7149188","+29.8879039"
"2453","482015430102","48",NA,"2",NA,1717,1133,584,551,221,268,1,58,0,3,33,2576,1725,851,799,281,431,1,81,0,5,52,"-095.7168333","+29.8823206"
"2454","482015430111","48",NA,"1",NA,2027,982,1045,1012,253,632,6,112,0,9,33,3113,1508,1605,1541,349,1019,6,150,0,17,64,"-095.7104550","+29.8919735"
"2455","482015430112","48",NA,"2",NA,1442,784,658,618,272,285,6,43,2,10,40,2062,1163,899,833,357,391,6,63,2,14,66,"-095.7064830","+29.8843297"
"2456","482015431001","48",NA,"1",NA,719,431,288,271,208,59,0,4,0,0,17,963,630,333,311,237,66,0,4,0,4,22,"-095.8816424","+30.0289137"
"2457","482015431002","48",NA,"2",NA,1337,657,680,652,527,113,3,9,0,0,28,2016,1062,954,898,684,202,3,9,0,0,56,"-095.8506413","+29.9626481"
"2458","482015432011","48",NA,"1",NA,2729,939,1790,1717,942,340,13,419,0,3,73,3393,1291,2102,1997,1081,406,13,485,0,12,105,"-095.5714192","+29.7960070"
"2459","482015432012","48",NA,"2",NA,1744,719,1025,981,589,194,9,186,0,3,44,2316,1074,1242,1179,691,262,9,211,0,6,63,"-095.5755282","+29.8020878"
"2460","482015432021","48",NA,"1",NA,863,160,703,672,557,37,8,70,0,0,31,1106,243,863,823,681,48,8,84,0,2,40,"-095.5831441","+29.7892437"
"2461","482015432022","48",NA,"2",NA,2066,511,1555,1507,801,309,6,389,0,2,48,2479,661,1818,1753,918,390,6,430,0,9,65,"-095.6055730","+29.8098912"
"2462","482015501011","48",NA,"1",NA,516,445,71,69,23,45,0,0,0,1,2,779,683,96,93,27,57,0,4,0,5,3,"-095.4205966","+29.9527591"
"2463","482015501012","48",NA,"2",NA,480,327,153,149,15,129,1,2,0,2,4,758,531,227,223,20,198,1,2,0,2,4,"-095.4233167","+29.9507725"
"2464","482015501013","48",NA,"3",NA,847,557,290,286,11,269,2,4,0,0,4,1389,888,501,496,22,467,2,5,0,0,5,"-095.4278905","+29.9506903"
"2465","482015501021","48",NA,"1",NA,699,179,520,508,33,472,0,2,0,1,12,1009,267,742,729,35,684,1,2,0,7,13,"-095.4421319","+29.9398822"
"2466","482015501022","48",NA,"2",NA,1035,465,570,557,32,520,0,3,0,2,13,1583,709,874,850,47,798,0,3,0,2,24,"-095.4295895","+29.9446311"
"2467","482015502011","48",NA,"1",NA,562,319,243,233,28,181,1,17,1,5,10,860,503,357,338,41,266,1,18,1,11,19,"-095.4200365","+29.9610887"
"2468","482015502012","48",NA,"2",NA,632,283,349,341,61,268,0,12,0,0,8,915,439,476,459,71,372,2,12,0,2,17,"-095.4260010","+29.9631552"
"2469","482015502021","48",NA,"1",NA,727,351,376,372,60,311,0,1,0,0,4,1100,562,538,526,80,444,0,1,0,1,12,"-095.4260850","+29.9594812"
"2470","482015502022","48",NA,"2",NA,694,272,422,403,14,368,5,16,0,0,19,1061,431,630,606,19,557,5,20,0,5,24,"-095.4319176","+29.9566573"
"2471","482015503031","48",NA,"1",NA,610,108,502,490,1,486,0,2,1,0,12,878,166,712,699,7,687,0,2,1,2,13,"-095.4249894","+29.9790406"
"2472","482015503032","48",NA,"2",NA,633,144,489,483,26,441,1,6,2,7,6,824,222,602,587,33,538,1,6,2,7,15,"-095.4234613","+29.9717866"
"2473","482015503033","48",NA,"3",NA,1594,406,1188,1162,77,1073,0,0,1,11,26,2435,630,1805,1757,89,1647,0,3,1,17,48,"-095.4311686","+29.9791854"
"2474","482015503041","48",NA,"1",NA,474,92,382,363,64,284,0,11,2,2,19,703,142,561,525,81,415,2,17,2,8,36,"-095.4306924","+30.0120804"
"2475","482015503042","48",NA,"2",NA,1009,144,865,849,66,742,0,31,1,9,16,1489,199,1290,1261,86,1124,3,37,1,10,29,"-095.4397882","+30.0154034"
"2476","482015503051","48",NA,"1",NA,1161,666,495,476,237,194,2,34,1,8,19,1565,932,633,599,269,274,2,40,1,13,34,"-095.4333613","+30.0004102"
"2477","482015503052","48",NA,"2",NA,1484,398,1086,1062,176,829,3,34,8,12,24,1947,563,1384,1355,193,1085,3,43,8,23,29,"-095.4396026","+30.0094269"
"2478","482015503061","48",NA,"1",NA,1528,357,1171,1149,133,983,1,29,0,3,22,2279,541,1738,1692,164,1472,2,37,0,17,46,"-095.4384252","+29.9912789"
"2479","482015503062","48",NA,"2",NA,1712,687,1025,1001,95,738,3,151,7,7,24,2501,1043,1458,1413,113,1084,3,195,7,11,45,"-095.4417583","+29.9858430"
"2480","482015503071","48",NA,"1",NA,880,155,725,701,68,616,2,10,4,1,24,1173,195,978,946,83,840,3,13,6,1,32,"-095.4508118","+30.0108978"
"2481","482015503072","48",NA,"2",NA,889,298,591,567,127,405,1,28,2,4,24,1271,434,837,794,139,608,2,36,4,5,43,"-095.4498177","+30.0031352"
"2482","482015503081","48",NA,"1",NA,1427,330,1097,1078,70,974,2,22,3,7,19,2195,520,1675,1634,88,1510,2,24,3,7,41,"-095.4278828","+29.9857004"
"2483","482015503082","48",NA,"2",NA,939,267,672,626,70,530,7,10,0,9,46,1316,377,939,884,86,758,9,15,0,16,55,"-095.4290929","+29.9939604"
"2484","482015504031","48",NA,"1",NA,879,236,643,636,58,566,0,1,11,0,7,1315,387,928,909,76,815,0,1,14,3,19,"-095.4274062","+29.9685985"
"2485","482015504032","48",NA,"2",NA,558,77,481,468,30,434,0,4,0,0,13,805,110,695,676,35,633,0,7,0,1,19,"-095.4332292","+29.9752009"
"2486","482015504033","48",NA,"3",NA,1181,378,803,787,43,714,0,17,5,8,16,1749,600,1149,1117,55,1027,0,20,5,10,32,"-095.4385320","+29.9669921"
"2487","482015504041","48",NA,"1",NA,853,288,565,559,66,477,0,16,0,0,6,1113,409,704,690,68,587,0,32,2,1,14,"-095.4384789","+29.9707856"
"2488","482015504042","48",NA,"2",NA,1856,470,1386,1360,51,1014,0,286,1,8,26,2469,665,1804,1772,72,1331,0,355,1,13,32,"-095.4641784","+29.9693895"
"2489","482015504043","48",NA,"3",NA,2073,443,1630,1607,50,1376,0,169,2,10,23,2684,656,2028,1987,66,1700,0,204,2,15,41,"-095.4498391","+29.9701793"
"2490","482015504051","48",NA,"1",NA,1610,435,1175,1133,180,886,5,52,2,8,42,2183,685,1498,1433,187,1154,5,71,2,14,65,"-095.4694218","+29.9987917"
"2491","482015504052","48",NA,"2",NA,1295,501,794,784,80,667,10,15,4,8,10,2008,809,1199,1176,89,1044,10,17,4,12,23,"-095.4661540","+30.0026882"
"2492","482015504053","48",NA,"3",NA,911,463,448,438,100,299,7,30,0,2,10,1363,757,606,582,119,418,11,30,1,3,24,"-095.4738129","+29.9918264"
"2493","482015504054","48",NA,"4",NA,685,503,182,171,87,48,0,34,0,2,11,1010,740,270,254,119,87,0,40,2,6,16,"-095.4728694","+29.9816246"
"2494","482015504061","48",NA,"1",NA,1078,524,554,541,44,425,0,63,3,6,13,1566,821,745,726,48,582,0,83,3,10,19,"-095.4554608","+29.9912308"
"2495","482015504062","48",NA,"2",NA,1464,690,774,747,123,588,8,16,3,9,27,2123,1076,1047,1007,144,821,8,17,3,14,40,"-095.4389128","+29.9769566"
"2496","482015504071","48",NA,"1",NA,3419,1111,2308,2263,105,1473,4,668,1,12,45,4945,1674,3271,3176,135,2137,4,876,4,20,95,"-095.4575753","+29.9779675"
"2497","482015505001","48",NA,"1",NA,1092,481,611,594,33,467,0,89,0,5,17,1531,712,819,797,40,633,0,118,0,6,22,"-095.4395604","+29.9536203"
"2498","482015505002","48",NA,"2",NA,727,236,491,480,27,385,1,60,1,6,11,914,324,590,576,30,474,1,60,2,9,14,"-095.4405009","+29.9483629"
"2499","482015505003","48",NA,"3",NA,1399,892,507,499,62,309,7,111,1,9,8,2004,1289,715,704,78,450,7,149,3,17,11,"-095.4495141","+29.9424610"
"2500","482015505004","48",NA,"4",NA,1110,575,535,521,63,273,4,174,4,3,14,1655,847,808,793,110,421,4,244,7,7,15,"-095.4463738","+29.9591407"
"2501","482015506011","48",NA,"1",NA,1935,1174,761,738,66,566,0,102,3,1,23,2595,1674,921,891,80,686,0,109,3,13,30,"-095.4585115","+29.9530245"
"2502","482015506012","48",NA,"2",NA,1043,459,584,562,63,423,0,76,0,0,22,1418,680,738,709,79,536,0,94,0,0,29,"-095.4552431","+29.9613444"
"2503","482015506013","48",NA,"3",NA,1974,1004,970,949,85,711,0,153,0,0,21,2660,1405,1255,1229,106,934,0,184,1,4,26,"-095.4607755","+29.9596547"
"2504","482015506021","48",NA,"1",NA,1190,618,572,559,32,381,0,126,5,15,13,1599,897,702,677,47,479,1,130,5,15,25,"-095.4592805","+29.9422461"
"2505","482015506022","48",NA,"2",NA,1032,555,477,464,38,339,4,70,5,8,13,1387,784,603,588,50,424,4,92,5,13,15,"-095.4597490","+29.9477559"
"2506","482015506031","48",NA,"1",NA,893,527,366,354,34,286,1,31,0,2,12,1274,796,478,457,40,374,1,38,1,3,21,"-095.4677180","+29.9536030"
"2507","482015506032","48",NA,"2",NA,1475,736,739,729,66,529,4,116,1,13,10,1975,1065,910,885,79,668,5,119,1,13,25,"-095.4695511","+29.9603630"
"2508","482015506033","48",NA,"3",NA,987,874,113,110,9,72,0,25,0,4,3,1523,1351,172,169,13,111,0,29,0,16,3,"-095.4767956","+29.9633089"
"2509","482015506034","48",NA,"4",NA,722,298,424,414,24,272,0,113,0,5,10,936,435,501,487,24,329,0,127,0,7,14,"-095.4736324","+29.9616576"
"2510","482015507001","48",NA,"1",NA,1792,648,1144,1101,155,666,0,274,0,6,43,2388,910,1478,1422,174,920,0,315,0,13,56,"-095.5037485","+29.9423180"
"2511","482015507002","48",NA,"2",NA,1075,666,409,395,45,228,0,116,0,6,14,1476,971,505,488,59,286,0,134,0,9,17,"-095.4764274","+29.9406721"
"2512","482015508001","48",NA,"1",NA,694,269,425,420,12,388,2,15,2,1,5,1178,447,731,720,16,671,2,21,2,8,11,"-095.4690077","+29.9463142"
"2513","482015508002","48",NA,"2",NA,1728,806,922,901,91,671,2,122,0,15,21,2345,1161,1184,1147,107,871,2,144,0,23,37,"-095.4761029","+29.9509869"
"2514","482015509011","48",NA,"1",NA,1607,848,759,737,158,289,0,271,0,19,22,2161,1207,954,920,171,386,3,335,0,25,34,"-095.4945922","+29.9531436"
"2515","482015509012","48",NA,"2",NA,1189,689,500,482,87,275,0,113,0,7,18,1615,924,691,649,102,388,1,147,0,11,42,"-095.4873114","+29.9494298"
"2516","482015509013","48",NA,"3",NA,1030,785,245,234,62,91,0,80,0,1,11,1439,1138,301,278,80,103,0,89,0,6,23,"-095.4826713","+29.9604649"
"2517","482015509021","48",NA,"1",NA,1863,907,956,927,94,324,4,483,1,21,29,2513,1278,1235,1187,123,426,7,604,1,26,48,"-095.4884139","+29.9577969"
"2518","482015509022","48",NA,"2",NA,1272,452,820,800,84,466,5,233,0,12,20,1698,653,1045,1008,94,613,6,274,0,21,37,"-095.4903908","+29.9630286"
"2519","482015510001","48",NA,"1",NA,988,731,257,230,51,92,3,73,0,11,27,1421,1087,334,303,59,137,3,93,0,11,31,"-095.4889439","+29.9722305"
"2520","482015510002","48",NA,"2",NA,1315,822,493,485,58,269,2,146,0,10,8,1854,1195,659,641,74,387,2,166,0,12,18,"-095.4935464","+29.9681618"
"2521","482015511011","48",NA,"1",NA,989,250,739,709,91,410,3,193,2,10,30,1286,373,913,871,110,517,3,229,2,10,42,"-095.4910797","+29.9853242"
"2522","482015511012","48",NA,"2",NA,840,310,530,507,97,325,0,79,2,4,23,1092,439,653,624,105,423,1,88,3,4,29,"-095.4861730","+29.9911320"
"2523","482015511013","48",NA,"3",NA,1549,594,955,946,160,579,3,188,1,15,9,2114,871,1243,1228,194,788,3,225,3,15,15,"-095.4828461","+29.9859280"
"2524","482015511021","48",NA,"1",NA,1550,923,627,619,82,436,0,82,2,17,8,2367,1489,878,858,94,619,0,98,2,45,20,"-095.4768191","+29.9697605"
"2525","482015511022","48",NA,"2",NA,1438,514,924,886,131,409,1,339,0,6,38,1819,711,1108,1059,153,500,1,396,0,9,49,"-095.4891795","+29.9810460"
"2526","482015511023","48",NA,"3",NA,922,327,595,582,51,248,2,281,0,0,13,1182,436,746,726,66,319,4,337,0,0,20,"-095.4814240","+29.9797516"
"2527","482015511024","48",NA,"4",NA,888,535,353,343,84,198,4,57,0,0,10,1222,783,439,414,102,244,5,63,0,0,25,"-095.4771190","+29.9765526"
"2528","482015512011","48",NA,"1",NA,971,383,588,554,332,169,6,47,0,0,34,1220,542,678,632,362,216,6,47,0,1,46,"-095.4988710","+29.9715439"
"2529","482015512012","48",NA,"2",NA,1318,688,630,550,196,133,7,212,0,2,80,1845,1021,824,701,235,169,8,279,0,10,123,"-095.4968316","+29.9792267"
"2530","482015512013","48",NA,"3",NA,1051,332,719,695,216,402,0,68,4,5,24,1473,510,963,927,242,579,2,95,4,5,36,"-095.5009178","+29.9833101"
"2531","482015512021","48",NA,"1",NA,1636,517,1119,1072,565,286,5,216,0,0,47,2187,759,1428,1349,651,418,8,265,4,3,79,"-095.5041071","+29.9667097"
"2532","482015512022","48",NA,"2",NA,682,220,462,450,196,232,0,21,0,1,12,895,318,577,554,217,308,0,26,0,3,23,"-095.5082727","+29.9794000"
"2533","482015513001","48",NA,"1",NA,1503,574,929,915,128,301,3,481,0,2,14,2038,804,1234,1209,145,471,3,584,0,6,25,"-095.5041683","+29.9526063"
"2534","482015513002","48",NA,"2",NA,1507,533,974,926,528,245,0,146,0,7,48,1919,756,1163,1095,582,305,0,187,0,21,68,"-095.5123061","+29.9508915"
"2535","482015514001","48",NA,"1",NA,790,289,501,482,268,191,2,19,0,2,19,1028,407,621,601,304,269,2,24,0,2,20,"-095.5148906","+29.9753771"
"2536","482015514002","48",NA,"2",NA,991,280,711,686,482,134,1,67,1,1,25,1261,422,839,792,536,172,1,78,1,4,47,"-095.5106976","+29.9707020"
"2537","482015514003","48",NA,"3",NA,695,227,468,442,84,319,3,30,1,5,26,938,309,629,593,98,446,3,38,1,7,36,"-095.5216718","+29.9625309"
"2538","482015514004","48",NA,"4",NA,1485,385,1100,1071,255,355,2,445,4,10,29,1936,579,1357,1315,276,462,2,558,4,13,42,"-095.5177329","+29.9573283"
"2539","482015515011","48",NA,"1",NA,766,680,86,75,56,8,0,11,0,0,11,1032,925,107,93,64,9,0,20,0,0,14,"-095.5543346","+29.9461032"
"2540","482015515012","48",NA,"2",NA,1204,578,626,612,149,388,0,65,0,10,14,1720,821,899,863,165,607,0,80,1,10,36,"-095.5699800","+29.9383660"
"2541","482015515013","48",NA,"3",NA,1102,351,751,727,188,455,4,73,0,7,24,1377,478,899,863,204,561,4,85,1,8,36,"-095.5477032","+29.9532344"
"2542","482015515021","48",NA,"1",NA,1282,236,1046,1006,142,517,2,328,2,15,40,1908,366,1542,1483,169,839,5,450,5,15,59,"-095.5341385","+29.9413375"
"2543","482015515022","48",NA,"2",NA,1988,686,1302,1284,251,281,0,750,0,2,18,2665,933,1732,1701,300,416,1,982,0,2,31,"-095.5552356","+29.9392455"
"2544","482015516011","48",NA,"1",NA,1280,595,685,669,317,181,7,164,0,0,16,1721,853,868,811,358,258,7,186,0,2,57,"-095.5548471","+29.9309254"
"2545","482015516012","48",NA,"2",NA,1029,483,546,524,251,162,1,107,0,3,22,1373,686,687,653,288,222,2,132,0,9,34,"-095.5623579","+29.9299216"
"2546","482015516021","48",NA,"1",NA,1436,556,880,845,355,318,1,162,2,7,35,1836,788,1048,1002,378,420,1,192,2,9,46,"-095.5812747","+29.9290722"
"2547","482015516022","48",NA,"2",NA,2458,1171,1287,1234,597,458,6,146,3,24,53,3389,1746,1643,1562,709,640,7,175,3,28,81,"-095.5713093","+29.9296699"
"2548","482015517021","48",NA,"1",NA,1392,212,1180,1137,587,81,3,466,0,0,43,1728,277,1451,1372,697,93,3,579,0,0,79,"-095.5567987","+29.8997343"
"2549","482015517022","48",NA,"2",NA,1596,276,1320,1265,782,106,0,366,0,11,55,1996,374,1622,1548,964,137,0,434,0,13,74,"-095.5653169","+29.9035424"
"2550","482015517031","48",NA,"1",NA,2172,721,1451,1408,643,413,5,335,0,12,43,2826,1005,1821,1755,773,565,7,394,0,16,66,"-095.5613432","+29.9214969"
"2551","482015517032","48",NA,"2",NA,1612,509,1103,1054,700,135,6,202,0,11,49,2041,695,1346,1271,817,175,6,255,0,18,75,"-095.5681506","+29.9159752"
"2552","482015517033","48",NA,"3",NA,803,223,580,572,204,218,7,140,0,3,8,1053,286,767,757,237,303,7,207,0,3,10,"-095.5567657","+29.9056415"
"2553","482015517034","48",NA,"4",NA,1473,426,1047,1011,595,116,1,299,0,0,36,1912,628,1284,1228,702,139,1,373,0,13,56,"-095.5614838","+29.9132159"
"2554","482015517041","48",NA,"1",NA,681,195,486,459,193,179,0,75,0,12,27,836,262,574,542,211,227,0,92,0,12,32,"-095.5822412","+29.9085334"
"2555","482015517042","48",NA,"2",NA,1079,202,877,857,405,85,6,361,0,0,20,1352,268,1084,1042,468,107,7,456,0,4,42,"-095.5776155","+29.8983939"
"2556","482015517043","48",NA,"3",NA,1344,213,1131,1078,868,67,5,129,0,9,53,1682,300,1382,1291,1038,83,5,154,0,11,91,"-095.5732180","+29.9028145"
"2557","482015517051","48",NA,"1",NA,1443,550,893,864,416,162,8,261,0,17,29,1844,769,1075,1023,480,199,8,319,0,17,52,"-095.5798414","+29.9198628"
"2558","482015517052","48",NA,"2",NA,702,289,413,388,279,65,2,40,0,2,25,913,392,521,488,342,94,2,43,0,7,33,"-095.5722856","+29.9160517"
"2559","482015517053","48",NA,"3",NA,791,279,512,482,276,101,0,104,0,1,30,1032,408,624,589,320,150,0,117,0,2,35,"-095.5721643","+29.9238107"
"2560","482015517054","48",NA,"4",NA,802,193,609,602,298,212,10,81,0,1,7,1007,268,739,729,333,291,10,94,0,1,10,"-095.5823582","+29.9115769"
"2561","482015517055","48",NA,"5",NA,601,192,409,394,301,63,2,28,0,0,15,766,261,505,482,352,87,2,35,0,6,23,"-095.5782118","+29.9132478"
"2562","482015518001","48",NA,"1",NA,1881,257,1624,1549,1388,51,3,97,0,10,75,2241,358,1883,1782,1591,66,3,112,0,10,101,"-095.5697920","+29.8874366"
"2563","482015518002","48",NA,"2",NA,865,121,744,697,606,13,1,72,0,5,47,1039,178,861,810,696,18,1,90,0,5,51,"-095.5575150","+29.8916205"
"2564","482015518003","48",NA,"3",NA,788,170,618,594,518,28,3,44,0,1,24,1005,251,754,718,620,36,3,58,0,1,36,"-095.5557088","+29.8812293"
"2565","482015519011","48",NA,"1",NA,607,226,381,362,130,209,0,23,0,0,19,781,310,471,444,153,260,0,29,0,2,27,"-095.5860409","+29.9066937"
"2566","482015519012","48",NA,"2",NA,1039,354,685,665,264,334,1,63,0,3,20,1284,444,840,811,283,448,1,74,0,5,29,"-095.5860890","+29.9011420"
"2567","482015519021","48",NA,"1",NA,758,256,502,478,171,282,1,22,0,2,24,948,328,620,589,189,371,1,26,0,2,31,"-095.5907163","+29.8972835"
"2568","482015519022","48",NA,"2",NA,1021,350,671,652,367,168,3,106,1,7,19,1231,455,776,745,405,192,3,133,1,11,31,"-095.5912002","+29.9025582"
"2569","482015519023","48",NA,"3",NA,1304,285,1019,978,232,665,0,63,0,18,41,1854,415,1439,1355,283,974,1,75,0,22,84,"-095.5893021","+29.9068699"
"2570","482015520021","48",NA,"1",NA,1269,290,979,940,479,310,0,146,0,5,39,1591,384,1207,1154,549,433,0,165,0,7,53,"-095.6088331","+29.9132313"
"2571","482015520031","48",NA,"1",NA,1552,272,1280,1239,387,315,1,528,1,7,41,1891,351,1540,1491,452,399,1,631,1,7,49,"-095.5981780","+29.9208954"
"2572","482015520032","48",NA,"2",NA,188,21,167,165,139,19,1,6,0,0,2,230,38,192,189,148,22,3,16,0,0,3,"-095.5883981","+29.9262402"
"2573","482015520033","48",NA,"3",NA,1768,478,1290,1241,864,179,6,175,6,11,49,2258,707,1551,1471,1005,225,6,218,6,11,80,"-095.5991066","+29.9163536"
"2574","482015520041","48",NA,"1",NA,963,174,789,763,495,195,2,66,4,1,26,1097,217,880,836,510,243,2,76,4,1,44,"-095.5978755","+29.9056943"
"2575","482015520042","48",NA,"2",NA,1511,527,984,946,388,399,1,147,5,6,38,2014,775,1239,1173,442,539,1,174,11,6,66,"-095.5898158","+29.9124690"
"2576","482015520043","48",NA,"3",NA,890,375,515,487,338,116,0,27,1,5,28,1149,539,610,572,375,152,1,36,3,5,38,"-095.5993462","+29.9105763"
"2577","482015521011","48",NA,"1",NA,1884,620,1264,1205,674,218,5,289,1,18,59,2445,854,1591,1475,804,274,5,368,1,23,116,"-095.6210263","+29.9251737"
"2578","482015521012","48",NA,"2",NA,1345,357,988,965,271,517,0,172,0,5,23,1840,509,1331,1300,341,740,0,214,0,5,31,"-095.6212759","+29.9189062"
"2579","482015521021","48",NA,"1",NA,1171,335,836,780,714,44,1,17,0,4,56,1481,488,993,919,827,60,2,26,0,4,74,"-095.6134063","+29.9403090"
"2580","482015521022","48",NA,"2",NA,1034,310,724,681,476,146,3,54,0,2,43,1392,471,921,851,545,225,4,72,0,5,70,"-095.6129617","+29.9463593"
"2581","482015521023","48",NA,"3",NA,1269,241,1028,1005,537,119,0,346,0,3,23,1608,347,1261,1222,643,149,0,425,0,5,39,"-095.6149329","+29.9334498"
"2582","482015521024","48",NA,"4",NA,1235,210,1025,987,623,73,0,287,0,4,38,1518,287,1231,1169,726,78,3,355,0,7,62,"-095.6103094","+29.9292769"
"2583","482015521031","48",NA,"1",NA,2467,820,1647,1576,1026,353,5,180,0,12,71,3260,1210,2050,1939,1246,453,5,219,0,16,111,"-095.6248007","+29.9382425"
"2584","482015522001","48",NA,"1",NA,1554,551,1003,940,653,181,4,97,4,1,63,2206,824,1382,1281,801,329,4,135,4,8,101,"-095.6326648","+29.9445401"
"2585","482015522002","48",NA,"2",NA,2295,681,1614,1542,976,333,8,198,3,24,72,3026,955,2071,1962,1186,460,8,276,3,29,109,"-095.6538252","+29.9506558"
"2586","482015522003","48",NA,"3",NA,2083,657,1426,1375,681,462,5,220,5,2,51,2866,947,1919,1837,816,711,5,297,5,3,82,"-095.6391839","+29.9370585"
"2587","482015523011","48",NA,"1",NA,1934,348,1586,1529,1307,157,3,45,2,15,57,2594,506,2088,1982,1654,237,6,54,2,29,106,"-095.6283423","+29.9592053"
"2588","482015523012","48",NA,"2",NA,1386,287,1099,1046,912,65,3,62,3,1,53,1766,419,1347,1260,1080,87,8,78,3,4,87,"-095.6135219","+29.9567545"
"2589","482015523031","48",NA,"1",NA,1194,339,855,788,468,267,1,48,2,2,67,1622,525,1097,1006,538,383,1,75,2,7,91,"-095.5892540","+29.9588406"
"2590","482015523032","48",NA,"2",NA,1158,267,891,848,387,324,1,113,6,17,43,1529,342,1187,1135,469,468,1,167,6,24,52,"-095.5892145","+29.9647119"
"2591","482015523041","48",NA,"1",NA,1028,195,833,803,623,75,2,96,0,7,30,1284,285,999,951,735,95,2,110,0,9,48,"-095.6005662","+29.9556975"
"2592","482015523042","48",NA,"2",NA,514,89,425,410,370,10,2,25,0,3,15,676,156,520,497,442,20,3,29,0,3,23,"-095.6026230","+29.9692085"
"2593","482015524011","48",NA,"1",NA,1145,308,837,820,302,378,6,133,0,1,17,1399,406,993,972,321,494,6,148,0,3,21,"-095.5966944","+29.9297636"
"2594","482015524012","48",NA,"2",NA,1242,532,710,693,263,323,2,99,0,6,17,1783,775,1008,966,316,517,4,117,0,12,42,"-095.6032278","+29.9285368"
"2595","482015524013","48",NA,"3",NA,841,235,606,573,211,95,2,264,0,1,33,1132,349,783,737,267,140,2,325,0,3,46,"-095.5896014","+29.9356725"
"2596","482015524021","48",NA,"1",NA,1278,459,819,781,591,120,4,62,0,4,38,1623,639,984,926,665,163,7,81,1,9,58,"-095.5936761","+29.9471705"
"2597","482015524022","48",NA,"2",NA,759,179,580,558,479,12,0,56,0,11,22,939,256,683,653,553,21,0,67,1,11,30,"-095.6007966","+29.9414038"
"2598","482015525011","48",NA,"1",NA,1177,399,778,726,369,309,1,40,0,7,52,1645,579,1066,996,441,488,2,58,0,7,70,"-095.5789009","+29.9416570"
"2599","482015525012","48",NA,"2",NA,1722,608,1114,1048,669,230,3,129,1,16,66,2259,848,1411,1318,792,344,3,162,1,16,93,"-095.5744261","+29.9488854"
"2600","482015525021","48",NA,"1",NA,1568,639,929,882,499,209,3,162,1,8,47,2090,897,1193,1108,600,286,3,208,1,10,85,"-095.5705606","+29.9535079"
"2601","482015525022","48",NA,"2",NA,1824,535,1289,1254,709,318,0,221,0,6,35,2412,788,1624,1566,832,448,1,278,0,7,58,"-095.5816855","+29.9559104"
"2602","482015525023","48",NA,"3",NA,1768,774,994,954,420,183,1,346,2,2,40,2405,1124,1281,1222,514,260,4,440,2,2,59,"-095.5748259","+29.9606335"
"2603","482015526021","48",NA,"1",NA,1847,390,1457,1384,1084,145,7,130,0,18,73,2459,631,1828,1719,1283,234,8,176,0,18,109,"-095.5854801","+29.9715925"
"2604","482015526022","48",NA,"2",NA,651,135,516,490,262,107,1,119,0,1,26,812,179,633,605,308,136,1,159,0,1,28,"-095.5782327","+29.9832351"
"2605","482015526023","48",NA,"3",NA,1944,420,1524,1492,742,488,11,240,3,8,32,2355,533,1822,1776,834,611,11,307,3,10,46,"-095.5699005","+29.9742148"
"2606","482015526024","48",NA,"4",NA,649,125,524,507,260,141,4,93,4,5,17,843,178,665,630,300,206,4,109,4,7,35,"-095.5668600","+29.9710227"
"2607","482015526025","48",NA,"5",NA,1161,258,903,880,423,238,0,205,1,13,23,1491,356,1135,1099,496,317,0,272,1,13,36,"-095.5754226","+29.9720815"
"2608","482015526031","48",NA,"1",NA,849,212,637,623,314,253,0,50,0,6,14,1019,261,758,737,339,322,0,69,0,7,21,"-095.5566792","+29.9654892"
"2609","482015526032","48",NA,"2",NA,1040,371,669,644,114,486,0,34,0,10,25,1523,555,968,918,134,729,0,45,0,10,50,"-095.5534476","+29.9601335"
"2610","482015526033","48",NA,"3",NA,724,216,508,492,75,320,2,93,0,2,16,1091,342,749,725,87,529,2,105,0,2,24,"-095.5599355","+29.9595713"
"2611","482015526041","48",NA,"1",NA,1754,569,1185,1136,517,226,12,372,1,8,49,2361,826,1535,1459,630,335,13,469,1,11,76,"-095.5739305","+29.9641416"
"2612","482015527011","48",NA,"1",NA,852,179,673,639,374,200,0,55,0,10,34,986,231,755,720,392,256,1,59,0,12,35,"-095.5444792","+29.9660780"
"2613","482015527012","48",NA,"2",NA,1138,337,801,772,265,320,2,179,0,6,29,1501,489,1012,969,312,429,2,218,0,8,43,"-095.5501072","+29.9696194"
"2614","482015527013","48",NA,"3",NA,839,125,714,687,427,79,1,178,0,2,27,1019,173,846,808,468,104,1,232,0,3,38,"-095.5479179","+29.9753141"
"2615","482015527021","48",NA,"1",NA,883,225,658,637,436,152,0,46,0,3,21,1132,292,840,801,506,220,0,69,0,6,39,"-095.5528658","+29.9803975"
"2616","482015527022","48",NA,"2",NA,774,258,516,489,392,74,3,16,1,3,27,1077,419,658,612,486,96,3,19,1,7,46,"-095.5574406","+29.9775435"
"2617","482015527023","48",NA,"3",NA,915,243,672,633,404,188,5,35,0,1,39,1148,348,800,743,443,255,5,37,1,2,57,"-095.5543257","+29.9878332"
"2618","482015527024","48",NA,"4",NA,1422,349,1073,1044,731,229,3,77,0,4,29,1714,464,1250,1200,816,290,3,86,1,4,50,"-095.5604496","+29.9821207"
"2619","482015528011","48",NA,"1",NA,960,184,776,760,548,154,3,50,0,5,16,1107,244,863,843,585,194,3,56,0,5,20,"-095.5402138","+29.9862708"
"2620","482015528012","48",NA,"2",NA,949,74,875,831,738,52,7,32,0,2,44,1030,113,917,867,764,59,7,33,0,4,50,"-095.5311999","+29.9884551"
"2621","482015528013","48",NA,"3",NA,1216,157,1059,1040,861,115,6,54,0,4,19,1470,244,1226,1192,974,144,6,64,0,4,34,"-095.5346090","+29.9802047"
"2622","482015528014","48",NA,"4",NA,1141,129,1012,983,768,121,5,76,2,11,29,1442,189,1253,1200,882,191,5,105,3,14,53,"-095.5404002","+29.9818635"
"2623","482015528021","48",NA,"1",NA,1676,325,1351,1307,599,547,2,146,0,13,44,2173,444,1729,1653,696,758,2,183,0,14,76,"-095.5390394","+29.9727837"
"2624","482015528022","48",NA,"2",NA,880,117,763,739,661,40,0,32,2,4,24,1079,154,925,888,779,58,0,44,2,5,37,"-095.5228378","+29.9785074"
"2625","482015528023","48",NA,"3",NA,857,155,702,672,407,194,2,59,3,7,30,1091,218,873,826,459,286,2,69,3,7,47,"-095.5304697","+29.9737109"
"2626","482015529011","48",NA,"1",NA,977,286,691,659,277,211,0,158,2,11,32,1302,416,886,850,314,313,0,208,2,13,36,"-095.5061963","+29.9937663"
"2627","482015529012","48",NA,"2",NA,1503,309,1194,1145,813,247,0,75,0,10,49,1757,393,1364,1307,877,314,0,95,0,21,57,"-095.5145622","+29.9948763"
"2628","482015529013","48",NA,"3",NA,1470,393,1077,1046,288,578,5,169,0,6,31,1982,545,1437,1387,330,824,5,218,0,10,50,"-095.5085825","+29.9922260"
"2629","482015529021","48",NA,"1",NA,959,136,823,799,574,78,1,137,0,9,24,1203,185,1018,980,685,110,3,168,0,14,38,"-095.5197915","+29.9992081"
"2630","482015529022","48",NA,"2",NA,1274,206,1068,1023,692,291,6,27,0,7,45,1601,298,1303,1249,780,419,6,36,0,8,54,"-095.5139447","+29.9853744"
"2631","482015529023","48",NA,"3",NA,990,116,874,838,743,51,1,34,2,7,36,1234,178,1056,998,879,61,4,42,2,10,58,"-095.5223294","+29.9918272"
"2632","482015530011","48",NA,"1",NA,1226,393,833,786,485,221,1,67,0,12,47,1521,561,960,899,536,273,1,74,0,15,61,"-095.5042417","+30.0064064"
"2633","482015530012","48",NA,"2",NA,2151,531,1620,1570,591,765,5,195,0,14,50,2655,704,1951,1865,669,937,5,235,0,19,86,"-095.4875268","+30.0037497"
"2634","482015530013","48",NA,"3",NA,1650,495,1155,1115,441,508,0,159,0,7,40,2223,714,1509,1447,513,732,0,193,0,9,62,"-095.4966908","+29.9962472"
"2635","482015530021","48",NA,"1",NA,1940,335,1605,1568,704,509,4,336,1,14,37,2284,455,1829,1776,751,621,7,371,1,25,53,"-095.4826867","+30.0076064"
"2636","482015530022","48",NA,"2",NA,541,227,314,299,191,72,0,34,0,2,15,692,314,378,357,208,100,2,45,0,2,21,"-095.4747198","+30.0173185"
"2637","482015530023","48",NA,"3",NA,1137,663,474,463,228,153,2,78,0,2,11,1594,1002,592,572,260,215,2,89,0,6,20,"-095.4791128","+30.0147440"
"2638","482015531011","48",NA,"1",NA,1263,449,814,778,373,334,0,67,0,4,36,1651,663,988,945,409,461,0,69,0,6,43,"-095.4650591","+30.0277595"
"2639","482015531012","48",NA,"2",NA,1395,311,1084,1041,395,579,2,54,2,9,43,1828,435,1393,1333,434,822,3,62,2,10,60,"-095.4713568","+30.0207366"
"2640","482015531021","48",NA,"1",NA,1386,496,890,862,372,428,4,37,3,18,28,1886,741,1145,1097,421,603,4,41,7,21,48,"-095.4564966","+30.0180097"
"2641","482015531022","48",NA,"2",NA,1341,366,975,953,311,536,5,80,4,17,22,1781,515,1266,1222,352,750,5,91,7,17,44,"-095.4625973","+30.0123345"
"2642","482015532011","48",NA,"1",NA,1104,447,657,635,346,243,4,37,0,5,22,1418,632,786,759,384,319,5,44,0,7,27,"-095.4525833","+30.0220286"
"2643","482015532012","48",NA,"2",NA,1100,475,625,596,238,327,0,23,0,8,29,1455,707,748,705,266,399,2,28,0,10,43,"-095.4447116","+30.0210987"
"2644","482015532021","48",NA,"1",NA,818,100,718,703,81,618,0,3,0,1,15,1180,154,1026,1009,81,921,0,3,0,4,17,"-095.4429035","+30.0287653"
"2645","482015532022","48",NA,"2",NA,1319,400,919,860,311,503,4,32,0,10,59,1781,548,1233,1153,347,749,8,35,0,14,80,"-095.4458248","+30.0318213"
"2646","482015532023","48",NA,"3",NA,1123,326,797,753,210,500,6,32,0,5,44,1499,478,1021,966,235,680,12,32,1,6,55,"-095.4441919","+30.0259150"
"2647","482015533001","48",NA,"1",NA,866,134,732,720,90,611,1,18,0,0,12,1183,188,995,975,99,857,1,18,0,0,20,"-095.4347763","+30.0298035"
"2648","482015533002","48",NA,"2",NA,1089,214,875,848,216,608,0,23,0,1,27,1411,318,1093,1056,225,794,1,28,1,7,37,"-095.4347051","+30.0258952"
"2649","482015533003","48",NA,"3",NA,721,177,544,527,53,465,3,5,0,1,17,1105,285,820,792,57,705,12,11,1,6,28,"-095.4385519","+30.0300506"
"2650","482015533004","48",NA,"4",NA,1274,208,1066,1019,110,867,3,30,1,8,47,1716,275,1441,1392,134,1200,5,32,6,15,49,"-095.4385547","+30.0270628"
"2651","482015534011","48",NA,"1",NA,1992,430,1562,1497,1155,194,7,133,1,7,65,2627,645,1982,1892,1441,263,7,169,1,11,90,"-095.4365548","+30.0416346"
"2652","482015534012","48",NA,"2",NA,1493,215,1278,1219,977,123,3,112,0,4,59,1929,315,1614,1526,1197,172,3,147,0,7,88,"-095.4559102","+30.0408509"
"2653","482015534031","48",NA,"1",NA,1937,451,1486,1420,912,369,6,131,1,1,66,2514,657,1857,1751,1095,494,6,151,2,3,106,"-095.4710012","+30.0578316"
"2654","482015534032","48",NA,"2",NA,2004,457,1547,1492,796,285,2,400,3,6,55,2822,704,2118,2005,1090,383,2,517,3,10,113,"-095.4851509","+30.0472594"
"2655","482015534033","48",NA,"3",NA,2308,600,1708,1638,828,425,3,373,0,9,70,2953,852,2101,1993,998,525,5,450,0,15,108,"-095.4587086","+30.0607511"
"2656","482015534041","48",NA,"1",NA,1227,231,996,957,793,77,6,78,0,3,39,1602,345,1257,1188,974,99,6,103,0,6,69,"-095.4584304","+30.0438890"
"2657","482015534042","48",NA,"2",NA,1251,148,1103,1064,876,96,6,83,0,3,39,1586,226,1360,1293,1057,122,6,98,0,10,67,"-095.4653250","+30.0476357"
"2658","482015534051","48",NA,"1",NA,1785,396,1389,1330,850,231,2,234,0,13,59,2328,557,1771,1696,1071,317,6,285,4,13,75,"-095.4530135","+30.0527688"
"2659","482015534052","48",NA,"2",NA,2503,637,1866,1785,981,521,4,274,0,5,81,3282,894,2388,2268,1167,730,8,350,0,13,120,"-095.4448664","+30.0560444"
"2660","482015535001","48",NA,"1",NA,1800,592,1208,1156,865,184,6,90,0,11,52,2441,845,1596,1494,1099,262,6,113,0,14,102,"-095.4815004","+30.0372626"
"2661","482015535002","48",NA,"2",NA,1274,269,1005,970,808,95,1,57,1,8,35,1736,423,1313,1249,1026,138,2,70,1,12,64,"-095.4731178","+30.0307694"
"2662","482015535003","48",NA,"3",NA,842,200,642,609,503,62,0,41,0,3,33,1115,309,806,758,621,86,2,46,0,3,48,"-095.4712454","+30.0428197"
"2663","482015535004","48",NA,"4",NA,1671,533,1138,1094,735,277,3,77,0,2,44,2161,738,1423,1359,895,361,4,95,0,4,64,"-095.4753971","+30.0408687"
"2664","482015536011","48",NA,"1",NA,1611,276,1335,1279,1078,113,0,80,0,8,56,2092,424,1668,1591,1338,142,0,98,0,13,77,"-095.4964253","+30.0285648"
"2665","482015536012","48",NA,"2",NA,875,114,761,737,667,40,2,28,0,0,24,1133,193,940,905,812,55,2,32,0,4,35,"-095.4908035","+30.0297745"
"2666","482015536013","48",NA,"3",NA,1080,183,897,866,554,127,0,184,0,1,31,1448,291,1157,1120,694,180,2,237,0,7,37,"-095.5036526","+30.0248717"
"2667","482015536021","48",NA,"1",NA,1215,426,789,761,325,279,3,140,1,13,28,1747,671,1076,1023,375,432,3,199,1,13,53,"-095.4865467","+30.0345586"
"2668","482015536022","48",NA,"2",NA,893,251,642,601,293,245,0,58,0,5,41,1137,329,808,753,340,322,0,84,0,7,55,"-095.4798548","+30.0254191"
"2669","482015537001","48",NA,"1",NA,587,104,483,466,358,79,0,28,0,1,17,746,148,598,571,437,103,0,30,0,1,27,"-095.5131394","+30.0238692"
"2670","482015537002","48",NA,"2",NA,1363,232,1131,1077,683,215,3,174,0,2,54,1726,329,1397,1318,801,281,4,228,0,4,79,"-095.5055955","+30.0123588"
"2671","482015537003","48",NA,"3",NA,1384,449,935,895,590,177,0,119,3,6,40,1912,681,1231,1167,731,252,0,166,4,14,64,"-095.5157364","+30.0164752"
"2672","482015538011","48",NA,"1",NA,1168,168,1000,963,767,106,4,78,2,6,37,1604,260,1344,1281,1017,155,5,96,2,6,63,"-095.5102012","+30.0430149"
"2673","482015538012","48",NA,"2",NA,1021,214,807,761,636,59,3,62,1,0,46,1352,319,1033,966,786,96,3,80,1,0,67,"-095.5003095","+30.0406514"
"2674","482015538031","48",NA,"1",NA,1785,348,1437,1371,831,219,4,308,0,9,66,2506,519,1987,1880,1093,326,5,442,0,14,107,"-095.5221951","+30.0416586"
"2675","482015538032","48",NA,"2",NA,1610,234,1376,1326,1048,132,4,128,0,14,50,2115,384,1731,1657,1286,181,5,170,0,15,74,"-095.5142247","+30.0328533"
"2676","482015538041","48",NA,"1",NA,2183,531,1652,1602,951,275,0,351,1,24,50,2942,777,2165,2100,1170,393,1,495,1,40,65,"-095.5353358","+30.0437718"
"2677","482015538042","48",NA,"2",NA,1168,438,730,691,434,151,3,97,3,3,39,1677,702,975,917,541,237,7,126,3,3,58,"-095.5213017","+30.0262299"
"2678","482015538043","48",NA,"3",NA,1222,383,839,806,604,119,4,72,0,7,33,1695,584,1111,1060,774,181,11,82,0,12,51,"-095.5267216","+30.0295395"
"2679","482015539011","48",NA,"1",NA,1302,159,1143,1088,774,131,1,177,5,0,55,1719,232,1487,1400,1022,153,2,216,5,2,87,"-095.5481965","+30.0329738"
"2680","482015539012","48",NA,"2",NA,1213,225,988,937,697,126,8,106,0,0,51,1628,324,1304,1219,906,188,10,113,2,0,85,"-095.5397263","+30.0373857"
"2681","482015539013","48",NA,"3",NA,1832,263,1569,1501,952,243,4,300,0,2,68,2362,388,1974,1854,1138,320,6,386,1,3,120,"-095.5378337","+30.0246861"
"2682","482015540011","48",NA,"1",NA,1033,383,650,621,448,124,0,43,0,6,29,1438,575,863,806,576,169,0,50,2,9,57,"-095.5232991","+30.0137044"
"2683","482015540012","48",NA,"2",NA,1715,293,1422,1374,1055,177,0,132,1,9,48,2117,402,1715,1635,1220,238,1,166,1,9,80,"-095.5270185","+30.0076227"
"2684","482015540021","48",NA,"1",NA,1414,152,1262,1206,1034,75,3,91,0,3,56,1806,215,1591,1505,1283,98,3,118,0,3,86,"-095.5401865","+29.9969492"
"2685","482015540022","48",NA,"2",NA,2035,231,1804,1740,1453,74,3,204,0,6,64,2550,333,2217,2106,1759,98,3,239,0,7,111,"-095.5470985","+30.0033888"
"2686","482015541031","48",NA,"1",NA,1261,278,983,948,707,89,0,149,0,3,35,1667,423,1244,1178,855,136,0,183,0,4,66,"-095.5533482","+30.0149779"
"2687","482015541032","48",NA,"2",NA,2256,547,1709,1610,1259,199,3,142,0,7,99,2979,816,2163,2018,1562,269,5,172,0,10,145,"-095.5583754","+30.0099550"
"2688","482015541033","48",NA,"3",NA,957,205,752,722,465,91,0,165,0,1,30,1240,294,946,889,571,119,0,197,0,2,57,"-095.5468092","+30.0141456"
"2689","482015541041","48",NA,"1",NA,1203,178,1025,978,631,96,1,248,0,2,47,1627,264,1363,1289,802,138,2,344,0,3,74,"-095.5603749","+30.0254223"
"2690","482015541042","48",NA,"2",NA,1508,281,1227,1176,887,97,8,178,0,6,51,1949,406,1543,1476,1111,143,8,208,0,6,67,"-095.5557290","+30.0200226"
"2691","482015542011","48",NA,"1",NA,1927,606,1321,1284,806,224,6,231,0,17,37,2522,850,1672,1608,963,297,6,318,0,24,64,"-095.5670059","+30.0064950"
"2692","482015542012","48",NA,"2",NA,2277,530,1747,1659,914,353,6,356,2,28,88,2887,739,2148,2024,1089,446,9,446,2,32,124,"-095.5641132","+29.9975706"
"2693","482015542021","48",NA,"1",NA,583,155,428,403,357,22,1,18,0,5,25,736,209,527,501,439,34,1,22,0,5,26,"-095.5716926","+30.0154155"
"2694","482015542022","48",NA,"2",NA,2303,560,1743,1685,1152,276,3,243,0,11,58,2932,766,2166,2078,1356,372,3,322,3,22,88,"-095.5690930","+29.9974798"
"2695","482015543011","48",NA,"1",NA,1338,184,1154,1118,976,62,5,67,0,8,36,1750,268,1482,1411,1219,79,5,98,0,10,71,"-095.5915951","+29.9834978"
"2696","482015543012","48",NA,"2",NA,1702,230,1472,1430,1340,50,4,27,0,9,42,2148,349,1799,1726,1609,69,4,35,0,9,73,"-095.6026226","+29.9904759"
"2697","482015543013","48",NA,"3",NA,1121,163,958,907,827,26,0,48,0,6,51,1455,220,1235,1144,1043,39,0,56,0,6,91,"-095.5861060","+29.9915043"
"2698","482015543014","48",NA,"4",NA,1563,215,1348,1285,1168,85,1,28,0,3,63,1922,288,1634,1544,1395,108,1,35,0,5,90,"-095.6063666","+29.9858579"
"2699","482015543021","48",NA,"1",NA,2074,324,1750,1667,1062,215,1,375,7,7,83,2759,463,2296,2169,1341,283,2,518,7,18,127,"-095.6143116","+29.9743210"
"2700","482015543022","48",NA,"2",NA,869,238,631,607,257,313,0,31,0,6,24,1311,382,929,886,332,501,4,41,2,6,43,"-095.6016358","+29.9779947"
"2701","482015543023","48",NA,"3",NA,552,82,470,448,410,25,0,13,0,0,22,698,137,561,533,474,41,0,16,0,2,28,"-095.6022655","+29.9807724"
"2702","482015544041","48",NA,"1",NA,1716,238,1478,1424,1252,84,4,68,0,16,54,2229,354,1875,1797,1568,114,4,93,0,18,78,"-095.6482118","+29.9816969"
"2703","482015544042","48",NA,"2",NA,1995,305,1690,1625,1202,131,1,277,0,14,65,2808,514,2294,2168,1567,183,3,400,0,15,126,"-095.6303331","+29.9695316"
"2704","482015544051","48",NA,"1",NA,2347,507,1840,1763,1228,284,11,218,2,20,77,3243,749,2494,2360,1607,406,11,302,2,32,134,"-095.7078978","+29.9798818"
"2705","482015544052","48",NA,"2",NA,1976,614,1362,1281,813,241,8,200,2,17,81,2808,892,1916,1787,1121,359,8,271,2,26,129,"-095.7027057","+29.9917137"
"2706","482015544053","48",NA,"3",NA,1459,269,1190,1135,727,186,6,210,1,5,55,2125,443,1682,1598,1020,273,6,289,1,9,84,"-095.7109476","+29.9908759"
"2707","482015544061","48",NA,"1",NA,3896,1006,2890,2771,1693,505,9,547,0,17,119,5838,1630,4208,3983,2365,774,16,803,0,25,225,"-095.7143330","+30.0135715"
"2708","482015544071","48",NA,"1",NA,2091,450,1641,1567,1188,236,3,129,0,11,74,2858,642,2216,2091,1552,330,3,188,0,18,125,"-095.6857695","+29.9887021"
"2709","482015544072","48",NA,"2",NA,1726,389,1337,1274,988,179,1,99,0,7,63,2313,577,1736,1653,1247,252,1,142,0,11,83,"-095.6835813","+29.9773724"
"2710","482015544073","48",NA,"3",NA,1185,169,1016,976,453,143,2,376,0,2,40,1541,218,1323,1265,561,188,2,512,0,2,58,"-095.6956740","+29.9920863"
"2711","482015544081","48",NA,"1",NA,1348,138,1210,1165,1053,35,1,69,0,7,45,1707,208,1499,1435,1288,53,2,84,0,8,64,"-095.6890193","+30.0058876"
"2712","482015544082","48",NA,"2",NA,1744,331,1413,1328,1131,94,1,98,0,4,85,2314,466,1848,1722,1448,138,1,123,0,12,126,"-095.6670727","+29.9840692"
"2713","482015544083","48",NA,"3",NA,3477,808,2669,2553,1870,337,0,309,7,30,116,4983,1297,3686,3500,2520,498,6,429,9,38,186,"-095.6709997","+29.9963367"
"2714","482015544091","48",NA,"1",NA,1186,148,1038,1009,879,40,0,87,0,3,29,1704,236,1468,1403,1212,56,2,127,0,6,65,"-095.6649961","+29.9676551"
"2715","482015544092","48",NA,"2",NA,1391,143,1248,1208,962,27,8,203,0,8,40,2083,229,1854,1781,1425,41,9,290,0,16,73,"-095.6607810","+29.9769485"
"2716","482015544093","48",NA,"3",NA,1109,129,980,943,696,96,2,146,0,3,37,1492,208,1284,1226,905,119,2,196,0,4,58,"-095.6796950","+29.9703453"
"2717","482015544094","48",NA,"4",NA,903,91,812,795,669,29,3,84,0,10,17,1280,154,1126,1084,928,33,3,110,0,10,42,"-095.6670647","+29.9755992"
"2718","482015544101","48",NA,"1",NA,987,171,816,774,724,33,1,12,0,4,42,1263,281,982,923,845,44,1,25,0,8,59,"-095.6415310","+29.9574868"
"2719","482015544102","48",NA,"2",NA,1665,223,1442,1402,1158,53,5,182,1,3,40,2337,337,2000,1919,1592,57,6,257,1,6,81,"-095.6565803","+29.9621164"
"2720","482015545011","48",NA,"1",NA,1842,433,1409,1346,1063,160,9,114,0,0,63,2534,648,1886,1796,1409,224,9,149,0,5,90,"-095.6751813","+30.0167328"
"2721","482015545012","48",NA,"2",NA,1789,322,1467,1430,1229,77,6,118,0,0,37,2506,507,1999,1918,1645,97,10,166,0,0,81,"-095.6479230","+30.0018295"
"2722","482015545013","48",NA,"3",NA,1412,421,991,959,680,149,5,124,1,0,32,2143,722,1421,1372,955,242,10,163,1,1,49,"-095.6498249","+30.0178807"
"2723","482015545021","48",NA,"1",NA,753,92,661,616,550,23,2,37,0,4,45,978,133,845,780,688,32,2,49,0,9,65,"-095.6256316","+29.9856061"
"2724","482015545022","48",NA,"2",NA,1868,258,1610,1566,1452,29,9,69,0,7,44,2492,426,2066,1984,1840,36,9,86,1,12,82,"-095.6367747","+29.9901360"
"2725","482015545023","48",NA,"3",NA,2074,342,1732,1649,1418,139,3,80,0,9,83,2796,513,2283,2146,1823,198,3,104,0,18,137,"-095.6355472","+29.9974029"
"2726","482015546001","48",NA,"1",NA,1790,284,1506,1418,1262,70,9,67,2,8,88,2356,406,1950,1824,1624,96,9,79,2,14,126,"-095.6156524","+30.0086517"
"2727","482015546002","48",NA,"2",NA,1860,178,1682,1649,1490,85,4,64,0,6,33,2293,267,2026,1958,1761,99,4,83,0,11,68,"-095.6200780","+29.9988654"
"2728","482015547011","48",NA,"1",NA,1396,280,1116,1050,776,135,2,134,0,3,66,1829,488,1341,1253,889,168,6,180,7,3,88,"-095.5873025","+29.9996344"
"2729","482015547012","48",NA,"2",NA,833,244,589,571,363,78,2,122,0,6,18,1089,323,766,743,459,102,3,172,0,7,23,"-095.5897504","+30.0071969"
"2730","482015547021","48",NA,"1",NA,1606,184,1422,1352,1068,86,3,189,0,6,70,2196,290,1906,1787,1416,114,3,248,0,6,119,"-095.5979952","+30.0079015"
"2731","482015547022","48",NA,"2",NA,2024,310,1714,1646,1432,79,2,133,0,0,68,2661,462,2199,2084,1816,101,2,159,0,6,115,"-095.6051825","+30.0012395"
"2732","482015548031","48",NA,"1",NA,2237,497,1740,1668,1405,130,9,111,0,13,72,3181,801,2380,2259,1894,189,18,139,1,18,121,"-095.5810113","+30.0786071"
"2733","482015548032","48",NA,"2",NA,2722,574,2148,2052,1687,240,2,104,6,13,96,3754,902,2852,2700,2166,356,8,147,10,13,152,"-095.5674390","+30.0934616"
"2734","482015548041","48",NA,"1",NA,1473,321,1152,1113,873,78,3,153,0,6,39,2006,510,1496,1424,1068,108,3,235,0,10,72,"-095.5556811","+30.0443021"
"2735","482015548042","48",NA,"2",NA,1948,459,1489,1449,1080,107,0,250,0,12,40,2897,714,2183,2094,1534,166,5,377,0,12,89,"-095.5594107","+30.0619957"
"2736","482015548051","48",NA,"1",NA,2492,816,1676,1585,975,323,9,272,3,3,91,3834,1381,2453,2289,1418,494,16,351,3,7,164,"-095.5862858","+30.0430290"
"2737","482015548052","48",NA,"2",NA,2016,511,1505,1450,796,188,2,454,3,7,55,3012,791,2221,2111,1113,299,5,662,8,24,110,"-095.5811294","+30.0312031"
"2738","482015548053","48",NA,"3",NA,1020,195,825,797,327,94,7,369,0,0,28,1456,308,1148,1101,438,143,8,511,0,1,47,"-095.5790868","+30.0219492"
"2739","482015548061","48",NA,"1",NA,1513,507,1006,952,683,152,8,100,1,8,54,2208,799,1409,1319,922,240,8,134,1,14,90,"-095.5981573","+30.0591520"
"2740","482015548071","48",NA,"1",NA,967,284,683,661,532,81,3,44,1,0,22,1350,434,916,879,682,136,3,56,1,1,37,"-095.6082771","+30.0477357"
"2741","482015548072","48",NA,"2",NA,1548,539,1009,957,694,188,11,52,2,10,52,2221,834,1387,1290,927,264,11,76,2,10,97,"-095.5962735","+30.0482379"
"2742","482015548073","48",NA,"3",NA,1927,605,1322,1246,840,182,2,218,0,4,76,2714,933,1781,1677,1101,291,2,276,0,7,104,"-095.6011758","+30.0421856"
"2743","482015548074","48",NA,"4",NA,718,361,357,347,195,121,0,30,0,1,10,985,534,451,438,250,145,0,41,0,2,13,"-095.5932091","+30.0325717"
"2744","482015548081","48",NA,"1",NA,919,121,798,782,626,24,7,117,1,7,16,1285,187,1098,1059,838,32,7,167,1,14,39,"-095.5688792","+30.0279826"
"2745","482015548082","48",NA,"2",NA,1147,150,997,943,765,55,1,119,0,3,54,1655,214,1441,1342,1056,86,3,191,1,5,99,"-095.5799279","+30.0456010"
"2746","482015548091","48",NA,"1",NA,3822,1260,2562,2436,1729,469,13,202,7,16,126,5863,2205,3658,3449,2419,697,14,282,9,28,209,"-095.5685290","+30.0742345"
"2747","482015548092","48",NA,"2",NA,1443,282,1161,1116,824,156,3,131,0,2,45,2041,415,1626,1547,1118,225,5,187,0,12,79,"-095.5799725","+30.0598077"
"2748","482015548093","48",NA,"3",NA,1809,182,1627,1573,1309,68,1,191,1,3,54,2501,304,2197,2104,1753,84,1,260,1,5,93,"-095.5662228","+30.0350300"
"2749","482015549021","48",NA,"1",NA,2876,440,2436,2333,2059,170,2,89,1,12,103,3885,665,3220,3054,2665,238,6,122,3,20,166,"-095.5263189","+30.1108547"
"2750","482015549022","48",NA,"2",NA,2778,729,2049,1953,1054,556,9,311,3,20,96,3960,1111,2849,2682,1411,810,10,420,7,24,167,"-095.5081890","+30.0798344"
"2751","482015549023","48",NA,"3",NA,1652,292,1360,1291,1217,33,0,33,0,8,69,2190,434,1756,1653,1545,55,0,39,1,13,103,"-095.5122908","+30.0998770"
"2752","482015549041","48",NA,"1",NA,1297,305,992,942,692,121,0,122,3,4,50,1871,475,1396,1314,977,160,2,165,3,7,82,"-095.5266074","+30.0700380"
"2753","482015549042","48",NA,"2",NA,1361,350,1011,958,600,180,5,165,0,8,53,1947,519,1428,1327,828,268,6,211,3,11,101,"-095.5159506","+30.0700495"
"2754","482015549051","48",NA,"1",NA,3111,494,2617,2539,1627,378,6,498,1,29,78,4360,731,3629,3476,2219,528,6,671,1,51,153,"-095.5315074","+30.0607627"
"2755","482015549052","48",NA,"2",NA,1868,237,1631,1574,1142,132,2,286,0,12,57,2487,357,2130,2012,1432,206,2,349,1,22,118,"-095.5072776","+30.0613466"
"2756","482015549061","48",NA,"1",NA,1438,334,1104,1054,733,159,0,160,0,2,50,2048,501,1547,1457,968,248,3,235,0,3,90,"-095.5026604","+30.0500243"
"2757","482015549062","48",NA,"2",NA,1473,344,1129,1083,739,162,0,172,0,10,46,1978,507,1471,1396,941,228,4,212,0,11,75,"-095.5002835","+30.0575890"
"2758","482015549071","48",NA,"1",NA,2326,787,1539,1493,764,430,3,278,5,13,46,3322,1161,2161,2062,1026,627,3,382,5,19,99,"-095.5232746","+30.0787033"
"2759","482015549072","48",NA,"2",NA,819,140,679,658,275,104,1,276,0,2,21,1211,244,967,929,375,164,3,382,3,2,38,"-095.5382473","+30.0776252"
"2760","482015549081","48",NA,"1",NA,1442,400,1042,993,884,72,1,25,0,11,49,2050,646,1404,1323,1173,105,1,25,1,18,81,"-095.5482245","+30.0965463"
"2761","482015549082","48",NA,"2",NA,1890,862,1028,988,660,208,6,108,0,6,40,2797,1409,1388,1315,861,294,6,141,2,11,73,"-095.5547917","+30.0819154"
"2762","482015549083","48",NA,"3",NA,1827,526,1301,1219,801,237,7,162,3,9,82,2661,821,1840,1711,1106,361,13,212,3,16,129,"-095.5398877","+30.0881024"
"2763","482015550011","48",NA,"1",NA,1797,474,1323,1260,655,318,2,271,6,8,63,2442,715,1727,1621,824,444,2,333,7,11,106,"-095.4600540","+30.0672810"
"2764","482015550021","48",NA,"1",NA,1523,377,1146,1097,915,132,6,34,4,6,49,2022,553,1469,1391,1138,187,12,42,4,8,78,"-095.4925223","+30.0676595"
"2765","482015550022","48",NA,"2",NA,1705,459,1246,1180,962,151,6,57,2,2,66,2346,716,1630,1542,1251,199,6,80,2,4,88,"-095.4845046","+30.0630153"
"2766","482015550023","48",NA,"3",NA,654,268,386,362,296,48,1,15,0,2,24,866,376,490,445,356,63,3,20,0,3,45,"-095.4927547","+30.0583406"
"2767","482015551011","48",NA,"1",NA,1323,419,904,878,435,222,6,210,3,2,26,1888,614,1274,1204,601,330,6,262,3,2,70,"-095.4883887","+30.0789393"
"2768","482015551012","48",NA,"2",NA,1650,540,1110,1055,664,194,0,183,3,11,55,2240,813,1427,1327,807,258,1,246,4,11,100,"-095.4805913","+30.0728353"
"2769","482015551013","48",NA,"3",NA,703,212,491,478,392,52,0,31,0,3,13,901,306,595,571,466,69,2,31,0,3,24,"-095.4702834","+30.0777565"
"2770","482015551021","48",NA,"1",NA,1140,284,856,804,603,118,1,80,0,2,52,1553,432,1121,1030,776,150,1,100,0,3,91,"-095.4608549","+30.0754909"
"2771","482015551022","48",NA,"2",NA,839,203,636,606,527,46,4,27,0,2,30,1154,353,801,749,641,65,4,36,0,3,52,"-095.4667082","+30.0763409"
"2772","482015551023","48",NA,"3",NA,2560,715,1845,1748,965,512,0,254,0,17,97,3153,953,2200,2075,1146,623,0,283,1,22,125,"-095.4458081","+30.0758728"
"2773","482015552001","48",NA,"1",NA,1814,459,1355,1315,941,217,7,149,0,1,40,2598,716,1882,1807,1259,348,7,189,0,4,75,"-095.4975865","+30.0890955"
"2774","482015552002","48",NA,"2",NA,2331,832,1499,1434,1151,176,3,95,1,8,65,3356,1355,2001,1899,1483,263,10,131,1,11,102,"-095.4892483","+30.1029949"
"2775","482015552003","48",NA,"3",NA,1710,575,1135,1056,888,119,7,36,1,5,79,2357,862,1495,1382,1139,176,10,47,1,9,113,"-095.4723239","+30.0876880"
"2776","482015552004","48",NA,"4",NA,1775,468,1307,1235,780,225,3,194,2,31,72,2155,600,1555,1451,887,300,3,222,2,37,104,"-095.4513828","+30.0950335"
"2777","482015553011","48",NA,"1",NA,3497,711,2786,2686,2087,320,4,245,2,28,100,4749,1012,3737,3559,2709,462,15,331,2,40,178,"-095.5170643","+30.1234693"
"2778","482015553031","48",NA,"1",NA,2022,393,1629,1568,1274,113,2,170,2,7,61,2985,666,2319,2184,1786,160,4,221,2,11,135,"-095.5687953","+30.1348325"
"2779","482015553032","48",NA,"2",NA,3735,876,2859,2719,2202,325,11,159,1,21,140,5363,1354,4009,3759,2991,496,13,218,1,40,250,"-095.5582554","+30.1229578"
"2780","482015553033","48",NA,"3",NA,2675,692,1983,1926,1542,87,5,272,2,18,57,4100,1131,2969,2826,2255,132,6,397,2,34,143,"-095.5556738","+30.1539220"
"2781","482015553034","48",NA,"4",NA,1016,245,771,729,499,170,8,48,0,4,42,1373,397,976,910,620,218,9,58,0,5,66,"-095.5821818","+30.1357859"
"2782","482015553041","48",NA,"1",NA,885,173,712,696,609,39,4,40,0,4,16,1190,282,908,870,747,64,5,49,0,5,38,"-095.5421515","+30.1345803"
"2783","482015553042","48",NA,"2",NA,2131,277,1854,1772,1459,90,6,214,0,3,82,2981,440,2541,2417,2000,122,9,276,0,10,124,"-095.5304016","+30.1288242"
"2784","482015553043","48",NA,"3",NA,1332,234,1098,1062,797,48,4,210,0,3,36,1783,330,1453,1372,994,76,4,294,0,4,81,"-095.5465938","+30.1183194"
"2785","482015553044","48",NA,"4",NA,1901,587,1314,1238,1062,84,11,80,0,1,76,2728,989,1739,1609,1371,120,11,100,0,7,130,"-095.5469614","+30.1293976"
"2786","482015553051","48",NA,"1",NA,1361,265,1096,1043,765,117,6,150,2,3,53,1897,380,1517,1424,1053,158,14,194,2,3,93,"-095.5095074","+30.1320388"
"2787","482015553052","48",NA,"2",NA,2131,476,1655,1543,1237,49,4,226,2,25,112,3422,850,2572,2352,1864,80,7,367,2,32,220,"-095.5206310","+30.1411691"
"2788","482015553053","48",NA,"3",NA,4790,1120,3670,3529,2791,195,11,510,3,19,141,7172,1762,5410,5115,4049,266,16,749,3,32,295,"-095.5371716","+30.1510018"
"2789","482015554011","48",NA,"1",NA,2318,460,1858,1800,1604,166,3,15,9,3,58,3032,685,2347,2261,2002,220,3,20,10,6,86,"-095.6076922","+30.1074172"
"2790","482015554031","48",NA,"1",NA,1257,241,1016,966,871,60,1,25,1,8,50,1596,332,1264,1200,1060,93,1,33,1,12,64,"-095.6243451","+30.0966916"
"2791","482015554032","48",NA,"2",NA,2171,285,1886,1835,1735,65,9,23,0,3,51,2828,416,2412,2326,2191,92,9,31,0,3,86,"-095.6321573","+30.1119553"
"2792","482015554041","48",NA,"1",NA,952,211,741,725,631,49,5,29,0,11,16,1181,301,880,841,727,64,5,34,0,11,39,"-095.6240730","+30.0900779"
"2793","482015554042","48",NA,"2",NA,1480,205,1275,1232,1073,141,3,7,0,8,43,1801,294,1507,1449,1227,200,3,9,0,10,58,"-095.6173684","+30.0821798"
"2794","482015554043","48",NA,"3",NA,889,194,695,659,563,76,3,14,0,3,36,1119,269,850,793,666,99,4,20,0,4,57,"-095.6054575","+30.0733887"
"2795","482015555011","48",NA,"1",NA,1802,576,1226,1166,1057,66,3,30,1,9,60,2386,819,1567,1436,1309,74,3,35,1,14,131,"-095.6547810","+30.0642589"
"2796","482015555012","48",NA,"2",NA,2368,459,1909,1854,1744,65,3,30,1,11,55,3111,669,2442,2358,2214,97,3,30,1,13,84,"-095.6690076","+30.0972982"
"2797","482015555031","48",NA,"1",NA,2228,436,1792,1720,1329,136,1,250,0,4,72,3296,697,2599,2468,1895,183,2,379,0,9,131,"-095.6315528","+30.0357844"
"2798","482015555032","48",NA,"2",NA,5139,1280,3859,3686,2810,352,12,482,3,27,173,7683,2100,5583,5278,4001,486,21,718,3,49,305,"-095.6663535","+30.0445985"
"2799","482015555033","48",NA,"3",NA,2986,625,2361,2258,1687,318,4,243,2,4,103,4114,932,3182,3006,2239,432,5,322,2,6,176,"-095.6119145","+30.0386458"
"2800","482015555041","48",NA,"1",NA,2586,410,2176,2087,1587,123,1,360,0,16,89,4061,719,3342,3162,2393,175,1,574,1,18,180,"-095.6304139","+30.0243776"
"2801","482015555042","48",NA,"2",NA,2473,734,1739,1654,1301,188,6,148,0,11,85,3382,1084,2298,2163,1658,266,6,214,1,18,135,"-095.6111403","+30.0303460"
"2802","482015555051","48",NA,"1",NA,2482,484,1998,1927,1163,262,1,479,0,22,71,3445,731,2714,2610,1551,336,1,682,0,40,104,"-095.6023757","+30.0200720"
"2803","482015555052","48",NA,"2",NA,2776,558,2218,2159,1416,216,2,511,3,11,59,4131,874,3257,3141,2040,329,2,740,3,27,116,"-095.6328615","+30.0123256"
"2804","482015555053","48",NA,"3",NA,2484,280,2204,2143,1703,110,6,320,0,4,61,3713,477,3236,3119,2460,154,9,484,0,12,117,"-095.6131422","+30.0204878"
"2805","482015556001","48",NA,"1",NA,1888,248,1640,1588,1506,30,14,24,0,14,52,2532,425,2107,2013,1905,45,17,24,0,22,94,"-095.7288727","+30.0903204"
"2806","482015556002","48",NA,"2",NA,1532,264,1268,1231,1117,75,1,33,0,5,37,1971,360,1611,1553,1400,87,3,52,0,11,58,"-095.7210238","+30.0490732"
"2807","482015556003","48",NA,"3",NA,1558,507,1051,1003,882,46,4,62,0,9,48,2229,759,1470,1395,1221,65,7,91,0,11,75,"-095.7519797","+30.0504852"
"2808","482015557011","48",NA,"1",NA,3073,848,2225,2139,1328,439,6,356,0,10,86,4566,1345,3221,3063,1866,681,8,490,0,18,158,"-095.7285599","+29.9946817"
"2809","482015557012","48",NA,"2",NA,1748,189,1559,1485,1312,76,7,80,1,9,74,2450,318,2132,2001,1770,104,16,101,1,9,131,"-095.7352702","+30.0078075"
"2810","482015557013","48",NA,"3",NA,1353,192,1161,1126,860,145,6,110,2,3,35,1927,299,1628,1561,1164,235,7,145,2,8,67,"-095.7488295","+30.0225956"
"2811","482015557014","48",NA,"4",NA,1621,302,1319,1264,918,242,5,85,13,1,55,2204,451,1753,1672,1198,311,6,135,13,9,81,"-095.7238269","+29.9844900"
"2812","482015557031","48",NA,"1",NA,859,88,771,730,682,31,3,14,0,0,41,1137,146,991,940,873,46,3,18,0,0,51,"-095.7426273","+30.0005305"
"2813","482015557032","48",NA,"2",NA,1661,251,1410,1347,1174,95,4,64,0,10,63,2353,407,1946,1841,1620,127,4,76,0,14,105,"-095.7487945","+30.0083735"
"2814","482015557033","48",NA,"3",NA,1121,165,956,917,737,106,3,63,0,8,39,1484,236,1248,1182,943,145,3,77,0,14,66,"-095.7480243","+29.9990500"
"2815","482015557034","48",NA,"4",NA,1343,235,1108,1041,847,107,7,72,5,3,67,1819,357,1462,1361,1116,139,12,86,5,3,101,"-095.7538381","+30.0001649"
"2816","482015557041","48",NA,"1",NA,2341,341,2000,1939,1568,172,3,191,0,5,61,3641,566,3075,2947,2370,263,5,299,0,10,128,"-095.7685622","+30.0161474"
"2817","482015557042","48",NA,"2",NA,2694,482,2212,2139,1678,223,4,225,0,9,73,4227,834,3393,3247,2552,350,7,325,0,13,146,"-095.7627736","+30.0058519"
"2818","482015560001","48",NA,"1",NA,917,307,610,584,386,167,4,20,0,7,26,1299,482,817,768,500,233,4,20,0,11,49,"-095.8973740","+30.0626869"
"2819","482015560002","48",NA,"2",NA,1615,670,945,922,679,196,0,45,0,2,23,2297,999,1298,1258,912,282,0,62,0,2,40,"-095.7901210","+30.0174761"
"2820","482015560003","48",NA,"3",NA,1983,966,1017,954,560,344,7,33,0,10,63,2883,1510,1373,1257,692,490,7,57,0,11,116,"-095.8096298","+30.0261857"
"2821","482015560004","48",NA,"4",NA,2793,1284,1509,1454,1148,240,3,55,1,7,55,4091,2049,2042,1938,1494,369,3,60,3,9,104,"-095.7904503","+30.0596123"
"2822","482015560005","48",NA,"5",NA,1447,553,894,873,686,144,6,32,0,5,21,1911,794,1117,1092,850,188,6,41,0,7,25,"-095.8683118","+30.0889251"
"2823","482015561001","48",NA,"1",NA,1674,255,1419,1355,1123,146,0,82,0,4,64,2261,383,1878,1762,1432,208,2,110,0,10,116,"-095.5409118","+30.0184025"
"2824","482015561002","48",NA,"2",NA,1138,167,971,927,820,57,0,45,0,5,44,1506,267,1239,1174,1021,83,2,57,0,11,65,"-095.5490480","+30.0260025"
"2825","482019800001","48",NA,"1",NA,16,3,13,10,5,5,0,0,0,0,3,20,5,15,12,5,7,0,0,0,0,3,"-095.2762041","+29.6471554"
"2826","482019801001","48",NA,"1",NA,2,0,2,1,0,0,0,0,0,1,1,5,0,5,4,2,1,0,0,0,1,1,"-095.3457951","+29.9858736"
"2827","482019802001","48",NA,"1",NA,8189,2201,5988,5976,2036,3897,3,39,0,1,12,8296,2244,6052,6036,2045,3946,3,39,0,3,16,"-095.3513042","+29.7663846"
"2828","482019803001","48",NA,"1",NA,2831,510,2321,2312,977,221,0,977,1,136,9,2849,520,2329,2317,982,221,0,977,1,136,12,"-095.4027324","+29.7172259"
"2829","482019804001","48",NA,"1",NA,3746,655,3091,3029,1296,364,1,1362,0,6,62,3751,659,3092,3030,1297,364,1,1362,0,6,62,"-095.3445785","+29.7222846"
"2830","482019807001","48",NA,"1",NA,2178,277,1901,1806,1370,300,7,111,0,18,95,2299,308,1991,1883,1416,318,7,122,0,20,108,"-095.3652480","+29.7621790"
